id,Geographic Area Name,Total Population,Female Total Population,Female Percentage,Male Percentage,Married percentage,50% below the poverty level,Poverty level percentage,High school graduate (includes equivalency) (18-24),Some college or associate's degree (18-24),Bachelor's degree or higher (18-24),High school graduate (includes equivalency) (>25),Some college or Associate's degree (>25),Bachelor's degree (>25),Graduate or professional degree (>25),High school graduate or higher (>25),Bachelor's degree or higher (>25),Total High school degree,Total Some college or associate's degree,Total Bachelor's degree,High school degree percentage,Some college or associate's degree percentage,Bachelor's degree percentage,Hispanic or Latino,Not Hispanic nor Latino,Hispanic or Latino population percentage,Not Hispanic nor Lation population percentage,White, Black or African American,American Indian and Alaska Native alone,Asian,Native Hawaiian and Other Pacific Islander alone, Some Other Race alone,
0500000US01001,"Autauga County, Alabama",55639,28587,51.38%,48.62%,52,3504,6.30%,1723,1720,612,11880,3323,6320,4401,33587,10721,13603,5043,6932,24.45%,9.06%,12%,2117,56688,3.80%,96.20%,41582,11352,184,873,22,185,
0500000US01003,"Baldwin County, Alabama",218289,112400,51.49%,48.51%,55.2,7250,3.32%,5569,6471,1360,42272,14357,31444,18192,140740,49636,47841,20828,32804,21.92%,9.54%,15%,12686,219081,5.81%,94.19%,186495,18001,1291,2029,122,775,
0500000US01005,"Barbour County, Alabama",25026,11870,47.43%,52.57%,38.5,3018,12.06%,875,585,84,6361,1385,1296,771,13300,2067,7236,1970,1380,28.91%,7.87%,6%,1510,23713,6.03%,93.97%,11086,11850,58,103,0,63,
0500000US01007,"Bibb County, Alabama",22374,10352,46.27%,53.73%,42.2,1875,8.38%,1104,351,24,7206,1087,1183,631,12931,1814,8310,1438,1207,37.14%,6.43%,5%,740,21553,3.31%,96.69%,16442,4390,39,26,9,47,
0500000US01009,"Blount County, Alabama",57755,29078,50.35%,49.65%,56,3834,6.64%,1833,1964,127,13975,5220,3540,1736,32976,5276,15808,7184,3667,27.37%,12.44%,6%,5771,53363,9.99%,90.01%,49764,826,188,174,11,100,
0500000US01011,"Bullock County, Alabama",10173,4595,45.17%,54.83%,34.1,1074,10.56%,496,383,44,2809,379,413,284,5084,697,3305,762,457,32.49%,7.49%,4%,503,9854,4.94%,95.06%,2281,7388,1,9,7,31,
0500000US01013,"Butler County, Alabama",19726,10676,54.12%,45.88%,43.7,1194,6.05%,710,446,52,6425,970,1396,809,11934,2205,7135,1416,1448,36.17%,7.18%,7%,260,18791,1.32%,98.68%,9679,8389,23,143,5,46,
0500000US01015,"Calhoun County, Alabama",114324,59399,51.96%,48.04%,47,7486,6.55%,3706,4751,849,27203,6080,8296,6594,67180,14890,30909,10831,9145,27.04%,9.47%,8%,5010,111431,4.38%,95.62%,79519,25365,386,1164,112,317,
0500000US01017,"Chambers County, Alabama",33427,17499,52.35%,47.65%,46.5,1628,4.87%,1149,1174,89,8829,2203,2491,942,19631,3433,9978,3377,2580,29.85%,10.10%,8%,1237,33535,3.70%,96.30%,18616,13441,71,385,11,115,
0500000US01019,"Cherokee County, Alabama",26035,13160,50.55%,49.45%,59.2,973,3.74%,947,650,59,7495,2098,1202,1274,15855,2476,8442,2748,1261,32.43%,10.56%,5%,400,24571,1.54%,98.46%,22563,987,109,55,1,46,
0500000US01021,"Chilton County, Alabama",44147,22627,51.25%,48.75%,51.5,2655,6.01%,1960,1028,39,13070,2427,2471,1636,24668,4107,15030,3455,2510,34.05%,7.83%,6%,4418,40596,10.01%,89.99%,34878,4040,112,176,5,121,
0500000US01023,"Choctaw County, Alabama",12755,6723,52.71%,47.29%,46.6,849,6.66%,279,377,25,3346,1068,761,491,7660,1252,3625,1445,786,28.42%,11.33%,6%,113,12552,0.89%,99.11%,7039,5217,24,19,0,13,
0500000US01025,"Clarke County, Alabama",23866,12517,52.45%,47.55%,44,3023,12.67%,885,755,111,6942,1436,1401,902,13799,2303,7827,2191,1512,32.80%,9.18%,6%,206,22881,0.86%,99.14%,11970,10223,74,91,1,37,
0500000US01027,"Clay County, Alabama",13285,6887,51.84%,48.16%,53.4,631,4.75%,539,412,16,3751,981,709,395,7615,1104,4290,1393,725,32.29%,10.49%,5%,449,13787,3.38%,96.62%,11261,1942,45,46,4,26,
0500000US01029,"Cleburne County, Alabama",14952,7684,51.39%,48.61%,54.5,689,4.61%,372,494,38,4044,638,1121,567,8661,1688,4416,1132,1159,29.53%,7.57%,8%,284,14772,1.90%,98.10%,13740,457,42,21,2,16,
0500000US01031,"Coffee County, Alabama",52238,26423,50.58%,49.42%,51.7,3774,7.22%,1575,1489,247,9876,4584,4993,2815,30778,7808,11451,6073,5240,21.92%,11.63%,10%,4887,48578,9.36%,90.64%,35759,8643,405,892,57,195,
0500000US01033,"Colbert County, Alabama",54957,28509,51.88%,48.13%,48.9,2912,5.30%,1874,1746,159,14452,3230,4263,2525,33487,6788,16326,4976,4422,29.71%,9.05%,8%,1732,55495,3.15%,96.85%,43241,9222,223,432,9,135,
0500000US01035,"Conecuh County, Alabama",12219,6268,51.30%,48.70%,41,1254,10.26%,367,243,0,4125,588,727,494,7498,1221,4492,831,727,36.76%,6.80%,6%,256,11341,2.10%,97.90%,5835,5096,71,33,0,16,
0500000US01037,"Coosa County, Alabama",10696,5197,48.59%,51.41%,46.5,500,4.67%,295,193,29,3482,578,659,298,6887,957,3777,771,688,35.31%,7.21%,6%,201,10186,1.88%,98.12%,6807,3000,25,8,0,47,
0500000US01039,"Covington County, Alabama",37096,19062,51.39%,48.61%,50.2,2857,7.70%,1147,956,142,9823,2726,2455,1662,22502,4117,10970,3682,2597,29.57%,9.93%,7%,654,36916,1.76%,98.24%,30657,4563,140,240,0,71,
0500000US01041,"Crenshaw County, Alabama",13826,7237,52.34%,47.66%,48.6,699,5.06%,394,402,26,3697,829,1271,521,7633,1792,4091,1231,1297,29.59%,8.90%,9%,187,13007,1.35%,98.65%,9333,3085,48,83,2,27,
0500000US01043,"Cullman County, Alabama",83345,42266,50.71%,49.29%,54,5084,6.10%,2278,2758,191,18747,6411,5889,3065,47782,8954,21025,9169,6080,25.23%,11.00%,7%,4146,83720,4.97%,95.03%,78298,914,287,522,64,151,
0500000US01045,"Dale County, Alabama",49293,25028,50.77%,49.23%,47.8,4427,8.98%,1668,1847,341,10358,3398,4208,1899,28599,6107,12026,5245,4549,24.40%,10.64%,9%,3254,46072,6.60%,93.40%,32602,10100,217,648,42,164,
0500000US01047,"Dallas County, Alabama",38184,20583,53.91%,46.10%,36.4,4431,11.60%,1329,1430,100,9277,3003,2634,1629,21500,4263,10606,4433,2734,27.78%,11.61%,7%,296,38166,0.78%,99.22%,10363,26812,56,145,12,38,
0500000US01049,"DeKalb County, Alabama",71430,36123,50.57%,49.43%,56.8,5315,7.44%,2181,2393,280,15809,5064,4166,2587,37691,6753,17990,7457,4446,25.19%,10.44%,6%,11744,59864,16.44%,83.56%,54529,1019,715,237,16,86,
0500000US01051,"Elmore County, Alabama",81526,42138,51.69%,48.31%,51.9,3076,3.77%,2969,2595,250,17958,5097,9546,5074,49420,14620,20927,7692,9796,25.67%,9.44%,12%,2793,85184,3.43%,96.57%,62540,18126,270,669,28,275,
0500000US01053,"Escambia County, Alabama",36775,18085,49.18%,50.82%,41.1,4410,11.99%,987,1012,100,11056,1939,2252,961,20653,3213,12043,2951,2352,32.75%,8.02%,6%,751,36006,2.04%,97.96%,22004,10922,1488,108,22,49,
0500000US01055,"Etowah County, Alabama",102721,53190,51.78%,48.22%,46.8,6589,6.41%,2505,4396,339,24104,6705,7764,5011,61597,12775,26609,11101,8103,25.90%,10.81%,8%,4895,98541,4.77%,95.23%,77731,14999,332,921,39,260,
0500000US01057,"Fayette County, Alabama",16406,8344,50.86%,49.14%,57.7,1490,9.08%,485,696,24,4934,926,1055,367,9743,1422,5419,1622,1079,33.03%,9.89%,7%,396,15925,2.41%,97.59%,13552,1720,43,49,1,29,
0500000US01059,"Franklin County, Alabama",31587,15956,50.51%,49.49%,49.1,2314,7.33%,900,1226,88,8223,1556,2164,1007,16578,3171,9123,2782,2252,28.88%,8.81%,7%,6259,25854,19.82%,80.18%,23581,1139,128,67,2,77,
0500000US01061,"Geneva County, Alabama",26383,13592,51.52%,48.48%,55.7,1497,5.67%,934,622,33,6751,2110,1451,994,15289,2445,7685,2732,1484,29.13%,10.36%,6%,1296,25363,4.91%,95.09%,21654,2231,166,86,7,72,
0500000US01063,"Greene County, Alabama",8221,4322,52.57%,47.43%,31.3,1329,16.17%,404,186,67,2301,481,332,252,4668,584,2705,667,399,32.90%,8.11%,5%,61,7669,0.74%,99.26%,1285,6227,5,7,0,11,
0500000US01065,"Hale County, Alabama",14754,7748,52.52%,47.49%,38.7,1123,7.61%,545,381,8,3730,978,1063,500,8085,1563,4275,1359,1071,28.98%,9.21%,7%,149,14636,1.01%,98.99%,5972,8313,34,18,5,23,
0500000US01067,"Henry County, Alabama",17123,8862,51.76%,48.25%,53.6,893,5.22%,499,719,20,3941,1127,1507,801,9829,2308,4440,1846,1527,25.93%,10.78%,9%,334,16812,1.95%,98.05%,11842,4232,50,73,0,49,
0500000US01069,"Houston County, Alabama",105319,54845,52.08%,47.93%,46.9,7680,7.29%,3246,3230,444,22968,6957,10109,6014,63299,16123,26214,10187,10553,24.89%,9.67%,10%,4481,102721,4.25%,95.75%,68251,28232,321,1260,59,354,
0500000US01071,"Jackson County, Alabama",51765,26442,51.08%,48.92%,54.2,2944,5.69%,1687,1394,50,14501,3295,3942,2076,30966,6018,16188,4689,3992,31.27%,9.06%,8%,1681,50898,3.25%,96.75%,45123,1624,680,214,2,109,
0500000US01073,"Jefferson County, Alabama",658615,347168,52.71%,47.29%,43.9,45576,6.92%,18615,24884,7862,118507,37742,94241,59011,407389,153252,137122,62626,102103,20.82%,9.51%,16%,34856,639865,5.29%,94.71%,324252,280112,1207,13043,311,1966,
0500000US01075,"Lamar County, Alabama",13854,7012,50.61%,49.39%,54.2,996,7.19%,328,525,53,4026,909,691,416,8138,1107,4354,1434,744,31.43%,10.35%,5%,208,13764,1.50%,98.50%,11924,1421,28,6,3,22,
0500000US01077,"Lauderdale County, Alabama",92870,48272,51.98%,48.02%,50,4762,5.13%,2599,6237,980,22358,5178,10244,5827,56793,16071,24957,11415,11224,26.87%,12.29%,12%,3078,90486,3.31%,96.69%,76491,9164,295,748,31,204,
0500000US01079,"Lawrence County, Alabama",32969,17165,52.06%,47.94%,54.9,2092,6.35%,994,879,163,9284,1748,2385,1324,18904,3709,10278,2627,2548,31.17%,7.97%,8%,895,32178,2.71%,97.29%,24714,3302,1440,84,7,69,
0500000US01081,"Lee County, Alabama",163461,82983,50.77%,49.23%,45,17749,10.86%,7229,17181,3410,22153,9956,19926,16253,89746,36179,29382,27137,23336,17.97%,16.60%,14%,9135,165106,5.59%,94.41%,109795,39252,365,8544,108,462,
0500000US01083,"Limestone County, Alabama",96921,48595,50.14%,49.86%,50.5,5117,5.28%,1822,3431,657,19941,5870,11872,5064,57962,16936,21763,9301,12529,22.45%,9.60%,13%,7248,96322,7.48%,92.52%,75692,13177,458,1857,70,319,
0500000US01085,"Lowndes County, Alabama",9936,5201,52.35%,47.66%,36.8,1014,10.21%,489,218,32,2840,658,557,453,5665,1010,3329,876,589,33.50%,8.82%,6%,140,10171,1.41%,98.59%,2807,7149,9,15,0,5,
0500000US01087,"Macon County, Alabama",18437,10041,54.46%,45.54%,36.3,1939,10.52%,387,2602,122,3652,960,1312,1131,9971,2443,4039,3562,1434,21.91%,19.32%,8%,361,19171,1.96%,98.04%,3187,15395,48,74,4,45,
0500000US01089,"Madison County, Alabama",367686,188110,51.16%,48.84%,50.5,18340,4.99%,9738,17096,4610,49140,18711,67834,42855,231504,110689,58878,35807,72444,16.01%,9.74%,20%,24936,363217,6.78%,93.22%,237497,91079,2132,10179,450,1702,
0500000US01091,"Marengo County, Alabama",19138,10145,53.01%,46.99%,37.8,1564,8.17%,695,780,34,4977,1384,1298,931,11129,2229,5672,2164,1332,29.64%,11.31%,7%,368,18955,1.92%,98.08%,8375,10133,6,54,1,41,
0500000US01093,"Marion County, Alabama",29818,15058,50.50%,49.50%,50.5,1666,5.59%,836,1059,78,7345,2301,1702,1140,17271,2842,8181,3360,1780,27.44%,11.27%,6%,863,28478,2.89%,97.11%,26093,1094,82,75,14,43,
0500000US01095,"Marshall County, Alabama",96137,48679,50.64%,49.37%,53.4,7591,7.90%,3011,2938,359,19988,5992,9037,4261,53596,13298,22999,8930,9396,23.92%,9.29%,10%,15658,81954,16.29%,83.71%,74666,2293,418,579,128,199,
0500000US01097,"Mobile County, Alabama",413977,216851,52.38%,47.62%,45.4,34406,8.31%,12966,15761,2689,93840,24162,45286,22951,244268,68237,106806,39923,47975,25.80%,9.64%,12%,13425,401384,3.24%,96.76%,226703,145435,3743,8515,216,1302,
0500000US01099,"Monroe County, Alabama",21006,10912,51.95%,48.05%,43,2686,12.79%,1037,389,134,6764,1172,1256,734,12262,1990,7801,1561,1390,37.14%,7.43%,7%,207,19565,0.99%,99.01%,10334,8253,281,88,0,44,
0500000US01101,"Montgomery County, Alabama",226451,119722,52.87%,47.13%,38.6,18554,8.19%,8226,9877,1646,36862,11508,29560,21275,131646,50835,45088,21385,31206,19.91%,9.44%,14%,10684,218270,4.72%,95.28%,73354,129801,364,7952,119,722,
0500000US01103,"Morgan County, Alabama",119352,60533,50.72%,49.28%,51.7,6779,5.68%,4217,3577,284,26213,7155,11982,5632,69492,17614,30430,10732,12266,25.50%,8.99%,10%,12377,111044,10.37%,89.63%,88238,15307,631,829,79,376,
0500000US01105,"Perry County, Alabama",9104,4760,52.29%,47.72%,24.4,802,8.81%,670,779,0,2065,242,661,359,4484,1020,2735,1021,661,30.04%,11.21%,7%,89,8422,0.98%,99.02%,2345,5914,15,10,1,0,
0500000US01107,"Pickens County, Alabama",20049,10475,52.25%,47.75%,44,1535,7.66%,654,591,119,5608,1032,1385,690,11919,2075,6262,1623,1504,31.23%,8.10%,8%,1053,18070,5.25%,94.75%,10066,7448,23,78,0,12,
0500000US01109,"Pike County, Alabama",33274,17263,51.88%,48.12%,32.6,4336,13.03%,1825,4614,762,6446,634,3095,2626,16868,5721,8271,5248,3857,24.86%,15.77%,12%,905,32104,2.72%,97.28%,18036,12068,169,577,9,117,
0500000US01111,"Randolph County, Alabama",22732,11701,51.47%,48.53%,51.9,1899,8.35%,650,995,53,5659,1633,1551,1184,13102,2735,6309,2628,1604,27.75%,11.56%,7%,605,21362,2.66%,97.34%,16629,3814,50,86,1,51,
0500000US01113,"Russell County, Alabama",57938,30129,52.00%,48.00%,46.8,6459,11.15%,1620,1879,333,11666,4849,4416,2455,33497,6871,13286,6728,4749,22.93%,11.61%,8%,3195,55988,5.51%,94.49%,26679,25930,180,408,128,234,
0500000US01115,"St. Clair County, Alabama",88929,44673,50.23%,49.77%,55.9,3893,4.38%,2628,2450,392,21716,5882,7745,3550,53455,11295,24344,8332,8137,27.37%,9.37%,9%,2575,88528,2.90%,97.10%,74962,8617,249,655,20,234,
0500000US01117,"Shelby County, Alabama",216350,111753,51.65%,48.35%,57.6,7055,3.26%,5405,8450,1828,28723,11656,42683,22654,137753,65337,34128,20106,44511,15.77%,9.29%,21%,16460,206564,7.61%,92.39%,162712,28711,478,5114,91,798,
0500000US01119,"Sumter County, Alabama",12595,6851,54.40%,45.61%,35.5,1691,13.43%,492,1833,16,2646,502,761,649,6529,1410,3138,2335,777,24.91%,18.54%,6%,131,12214,1.04%,98.96%,2937,8955,26,102,3,9,
0500000US01121,"Talladega County, Alabama",80244,41539,51.77%,48.23%,44.6,6354,7.92%,2941,3139,190,18777,4854,4948,3619,45910,8567,21718,7993,5138,27.06%,9.96%,6%,1779,80370,2.22%,97.78%,50732,26340,184,395,27,206,
0500000US01123,"Tallapoosa County, Alabama",40450,20818,51.47%,48.53%,49.9,3052,7.55%,1655,954,57,9483,2246,3417,2001,23388,5418,11138,3200,3474,27.54%,7.91%,9%,1144,40167,2.83%,97.17%,28252,10366,84,222,0,91,
0500000US01125,"Tuscaloosa County, Alabama",208854,108309,51.86%,48.14%,43.1,17182,8.23%,9518,20371,2714,37890,10881,23944,16838,117217,40782,47408,31252,26658,22.70%,14.96%,13%,12298,214738,5.89%,94.11%,134880,68779,420,3241,94,792,
0500000US01127,"Walker County, Alabama",63802,32466,50.89%,49.11%,52.3,4692,7.35%,1708,2225,181,15621,4501,3768,2221,36445,5989,17329,6726,3949,27.16%,10.54%,6%,2152,63190,3.37%,96.63%,56394,3889,187,283,2,136,
0500000US01129,"Washington County, Alabama",16336,8248,50.49%,49.51%,50.6,1036,6.34%,591,972,14,4925,940,700,907,9571,1607,5516,1912,714,33.77%,11.70%,4%,138,15250,0.84%,99.16%,10267,3318,1102,14,2,23,
0500000US01131,"Wilcox County, Alabama",10552,5681,53.84%,46.16%,33.6,870,8.24%,421,286,8,2853,427,557,266,5597,823,3274,713,565,31.03%,6.76%,5%,112,10488,1.06%,98.94%,2866,7425,11,7,5,16,
0500000US01133,"Winston County, Alabama",23712,12065,50.88%,49.12%,54.9,1738,7.33%,626,470,81,6653,1145,1366,916,13483,2282,7279,1615,1447,30.70%,6.81%,6%,815,22725,3.44%,96.56%,21598,131,83,58,9,39,
0500000US02013,"Aleutians East Borough, Alaska",3389,1433,42.28%,57.72%,45.9,121,3.57%,122,109,46,1077,156,277,161,2292,438,1199,265,323,35.38%,7.82%,10%,674,2746,19.89%,80.11%,658,297,797,771,32,11,
0500000US02016,"Aleutians West Census Area, Alaska",5708,2065,36.18%,63.82%,48.1,207,3.63%,197,185,7,1789,279,605,111,3863,716,1986,464,612,34.79%,8.13%,11%,668,4564,11.70%,88.30%,1585,257,709,1502,238,10,
0500000US02020,"Anchorage Municipality, Alaska",292090,143136,49.00%,51.00%,49.5,10951,3.75%,11483,12312,2072,45638,17176,43695,26664,180790,70359,57121,29488,45767,19.56%,10.10%,16%,26438,264809,9.05%,90.95%,158232,13777,22480,27281,9844,1922,
0500000US02050,"Bethel Census Area, Alaska",18263,8802,48.20%,51.80%,36.7,2260,12.37%,823,348,43,4789,502,559,556,8213,1115,5612,850,602,30.73%,4.65%,3%,207,18459,1.13%,98.87%,1628,84,15580,201,2,19,
0500000US02060,"Bristol Bay Borough, Alaska",739,325,43.98%,56.02%,59.4,16,2.17%,13,15,5,168,32,114,31,526,145,181,47,119,24.49%,6.36%,16%,45,799,6.09%,93.91%,357,6,296,5,3,2,
0500000US02063,"Chugach Census Area, Alaska",6495,2922,44.99%,55.01%,58.9,276,4.25%,260,108,22,1126,492,764,598,4482,1362,1386,600,786,21.34%,9.24%,12%,397,6705,6.11%,93.89%,4768,46,657,527,61,26,
0500000US02066,"Copper River Census Area, Alaska",2894,1520,52.52%,47.48%,55.9,108,3.73%,63,69,0,650,123,327,266,1794,593,713,192,327,24.64%,6.63%,11%,84,2533,2.90%,97.10%,1591,6,645,17,10,15,
0500000US02068,"Denali Borough, Alaska",2502,1144,45.72%,54.28%,43.5,224,8.95%,111,184,6,563,130,478,252,1824,730,674,314,484,26.94%,12.55%,19%,32,1587,1.28%,98.72%,1378,9,59,13,3,4,
0500000US02070,"Dillingham Census Area, Alaska",4934,2407,48.78%,51.22%,39.4,349,7.07%,243,108,16,1165,177,247,316,2511,563,1408,285,263,28.54%,5.78%,5%,146,4711,2.96%,97.04%,770,19,3412,45,9,7,
0500000US02090,"Fairbanks North Star Borough, Alaska",98455,45346,46.06%,53.94%,52.4,3246,3.30%,5229,6314,813,14863,5916,11625,8329,58299,19954,20092,12230,12438,20.41%,12.42%,13%,7320,88335,7.43%,92.57%,63178,3804,7299,3031,584,812,
0500000US02100,"Haines Borough, Alaska",2547,1132,44.44%,55.56%,51.9,187,7.34%,24,0,0,569,56,278,182,1629,460,593,56,278,23.28%,2.20%,11%,67,2013,2.63%,97.37%,1577,2,205,14,2,9,
0500000US02105,"Hoonah-Angoon Census Area, Alaska",2135,986,46.18%,53.82%,44.9,63,2.95%,67,23,0,635,201,255,87,1639,342,702,224,255,32.88%,10.49%,12%,120,2245,5.62%,94.38%,1123,6,841,15,4,16,
0500000US02110,"Juneau City and Borough, Alaska",32099,15625,48.68%,51.32%,48.9,1260,3.93%,878,1077,289,4870,1865,5722,3047,21756,8769,5748,2942,6011,17.91%,9.17%,19%,2077,30178,6.47%,93.53%,19673,328,3397,2086,469,183,
0500000US02122,"Kenai Peninsula Borough, Alaska",58809,28214,47.98%,52.02%,51.2,3164,5.38%,2003,1626,220,12870,3541,6650,3972,38279,10622,14873,5167,6870,25.29%,8.79%,12%,2328,56471,3.96%,96.04%,45546,361,4107,793,173,372,
0500000US02130,"Ketchikan Gateway Borough, Alaska",13833,6701,48.44%,51.56%,50,607,4.39%,558,398,63,2975,789,1641,826,9097,2467,3533,1187,1704,25.54%,8.58%,12%,650,13298,4.70%,95.30%,8221,100,2264,1118,26,93,
0500000US02150,"Kodiak Island Borough, Alaska",13383,6239,46.62%,53.38%,53.7,393,2.94%,497,376,33,2415,680,1597,1055,7973,2652,2912,1056,1630,21.76%,7.89%,12%,1024,12077,7.65%,92.35%,6291,85,1759,2781,107,74,
0500000US02158,"Kusilvak Census Area, Alaska",8298,3813,45.95%,54.05%,30,1409,16.98%,487,87,2,2193,79,107,25,3179,132,2680,166,109,32.30%,2.00%,1%,14,8354,0.17%,99.83%,173,16,7946,23,0,14,
0500000US02164,"Lake and Peninsula Borough, Alaska",1156,626,54.15%,45.85%,44.5,76,6.57%,36,19,59,256,44,76,90,633,166,292,63,135,25.26%,5.45%,12%,34,1442,2.94%,97.06%,297,1,993,7,0,0,
0500000US02170,"Matanuska-Susitna Borough, Alaska",107360,51589,48.05%,51.95%,49.3,5789,5.39%,4074,2829,321,23703,6987,10004,5293,65351,15297,27777,9816,10325,25.87%,9.14%,10%,5244,101837,4.88%,95.12%,81050,1059,6531,1515,476,785,
0500000US02180,"Nome Census Area, Alaska",10009,4760,47.56%,52.44%,33.4,958,9.57%,644,214,27,2392,160,465,472,4752,937,3036,374,492,30.33%,3.74%,5%,186,9860,1.86%,98.14%,1393,52,7508,109,5,25,
0500000US02185,"North Slope Borough, Alaska",9375,3694,39.40%,60.60%,46.5,428,4.57%,356,199,46,2539,478,700,236,5489,936,2895,677,746,30.88%,7.22%,8%,548,10483,5.85%,94.15%,2964,159,5680,636,321,30,
0500000US02188,"Northwest Arctic Borough, Alaska",7709,3487,45.23%,54.77%,31.2,883,11.45%,411,133,16,1994,202,354,285,3593,639,2405,335,370,31.20%,4.35%,5%,102,7691,1.32%,98.68%,684,71,6453,53,11,0,
0500000US02195,"Petersburg Borough, Alaska",3278,1618,49.36%,50.64%,53.8,65,1.98%,155,59,4,836,201,486,148,2215,634,991,260,490,30.23%,7.93%,15%,164,3234,5.00%,95.00%,2444,46,231,117,12,21,
0500000US02198,"Prince of Wales-Hyder Census Area, Alaska",6338,2869,45.27%,54.73%,48.5,399,6.30%,232,80,11,1700,376,527,240,4069,767,1932,456,538,30.48%,7.19%,8%,160,5593,2.52%,97.48%,2368,21,2529,25,30,16,
0500000US02220,"Sitka City and Borough, Alaska",8569,4162,48.57%,51.43%,53.9,265,3.09%,247,240,49,1549,693,1344,751,5830,2095,1796,933,1393,20.96%,10.89%,16%,501,7957,5.85%,94.15%,5050,37,1206,573,14,53,
0500000US02230,"Skagway Municipality, Alaska",1300,645,49.62%,50.39%,38.6,37,2.85%,28,32,4,319,56,202,52,930,254,347,88,206,26.69%,6.77%,16%,41,1199,3.15%,96.85%,1056,6,23,39,0,6,
0500000US02240,"Southeast Fairbanks Census Area, Alaska",6911,3147,45.54%,54.46%,52,442,6.40%,164,117,86,1624,425,500,479,4201,979,1788,542,586,25.87%,7.84%,8%,376,6432,5.44%,94.56%,4993,68,795,87,13,23,
0500000US02275,"Wrangell City and Borough, Alaska",2510,1154,45.98%,54.02%,54.1,141,5.62%,25,46,12,611,176,216,101,1657,317,636,222,228,25.34%,8.84%,9%,76,2051,3.03%,96.97%,1341,0,368,25,2,11,
0500000US02282,"Yakutat City and Borough, Alaska",597,243,40.70%,59.30%,42,22,3.69%,12,4,3,178,20,66,11,404,77,190,24,69,31.83%,4.02%,12%,29,633,4.86%,95.14%,248,2,250,32,1,0,
0500000US02290,"Yukon-Koyukuk Census Area, Alaska",5305,2533,47.75%,52.25%,34.2,516,9.73%,254,103,24,1430,150,280,170,2990,450,1684,253,304,31.74%,4.77%,6%,72,5271,1.36%,98.64%,1121,6,3818,8,3,16,
0500000US04001,"Apache County, Arizona",71714,36326,50.65%,49.35%,35.4,13487,18.81%,2376,2911,61,14235,3499,3496,2209,37148,5705,16611,6410,3557,23.16%,8.94%,5%,3861,62160,5.38%,94.62%,13791,184,46509,307,18,115,
0500000US04003,"Cochise County, Arizona",126442,62071,49.09%,50.91%,50.2,6555,5.18%,4232,4413,359,21183,10060,13890,8691,78362,22581,25415,14473,14249,20.10%,11.45%,11%,42615,82832,33.70%,66.30%,68256,4371,762,2587,421,725,
0500000US04005,"Coconino County, Arizona",142254,72130,50.71%,49.30%,38.2,10699,7.52%,9126,16262,2022,18325,6936,18949,12777,76717,31726,27451,23198,20971,19.30%,16.31%,15%,21719,123382,15.27%,84.73%,76904,1777,35143,2582,254,616,
0500000US04007,"Gila County, Arizona",53846,27175,50.47%,49.53%,50.4,4907,9.11%,1320,1060,141,11390,3342,4784,2850,34677,7634,12710,4402,4925,23.60%,8.18%,9%,9283,43989,17.24%,82.76%,32757,239,8655,427,45,203,
0500000US04009,"Graham County, Arizona",38304,17846,46.59%,53.41%,42,3769,9.84%,1104,1724,171,7298,2736,2422,1144,20527,3566,8402,4460,2593,21.94%,11.64%,7%,11428,27105,29.84%,70.16%,20398,453,5143,169,16,102,
0500000US04011,"Greenlee County, Arizona",9465,4403,46.52%,53.48%,50.5,638,6.74%,577,393,0,1742,443,777,183,4872,960,2319,836,777,24.50%,8.83%,8%,4376,5187,46.23%,53.77%,4446,80,275,68,1,34,
0500000US04012,"La Paz County, Arizona",21035,10285,48.90%,51.11%,52.6,2427,11.54%,288,406,7,5488,1218,1378,585,13355,1963,5776,1624,1385,27.46%,7.72%,7%,4197,12360,19.95%,80.05%,9061,102,2354,111,41,43,
0500000US04013,"Maricopa County, Arizona",4412779,2230812,50.55%,49.45%,47.1,257624,5.84%,141276,167314,44629,659883,257177,621592,364998,2609466,986590,801159,424491,666221,18.16%,9.62%,15%,1351415,3069153,30.63%,69.37%,2357571,245239,68353,197910,9579,20693,
0500000US04015,"Mohave County, Arizona",210998,104556,49.55%,50.45%,50.1,14206,6.73%,4998,3750,672,55708,14690,13499,8250,140182,21749,60706,18440,14171,28.77%,8.74%,7%,34126,179141,16.17%,83.83%,160165,2063,4053,2600,365,690,
0500000US04017,"Navajo County, Arizona",110271,54994,49.87%,50.13%,43.2,14244,12.92%,3868,2490,375,21002,6354,6898,4690,60298,11588,24870,8844,7273,22.55%,8.02%,7%,10887,95830,9.87%,90.13%,44786,674,46572,548,68,232,
0500000US04019,"Pima County, Arizona",1038476,527601,50.81%,49.20%,44.8,74465,7.17%,38982,55114,10876,150259,62271,135389,99943,622956,235332,189241,117385,146265,18.22%,11.30%,14%,372788,670645,35.90%,64.10%,536868,36254,23670,29844,1937,4657,
0500000US04021,"Pinal County, Arizona",447559,215137,48.07%,51.93%,50.4,24356,5.44%,13879,11911,1736,94443,30704,43742,21333,271107,65075,108322,42615,45478,24.20%,9.52%,10%,121533,303731,27.15%,72.85%,240006,20712,17156,6290,1081,1658,
0500000US04023,"Santa Cruz County, Arizona",46594,24158,51.85%,48.15%,50.6,3344,7.18%,1383,1699,184,8158,2242,3891,2318,23100,6209,9541,3941,4075,20.48%,8.46%,9%,39632,8037,85.06%,14.94%,7119,114,78,271,13,150,
0500000US04025,"Yavapai County, Arizona",232396,118897,51.16%,48.84%,52.7,12260,5.28%,5053,7440,530,46987,17109,26947,20274,164901,47221,52040,24549,27477,22.39%,10.56%,12%,34390,201819,14.80%,85.20%,183296,1415,3319,2802,269,1071,
0500000US04027,"Yuma County, Arizona",211931,102694,48.46%,51.54%,52.4,16334,7.71%,7303,12010,934,35887,10372,13574,7225,100469,20799,43190,22382,14508,20.38%,10.56%,7%,130003,73878,61.34%,38.66%,61123,3484,1888,2321,215,622,
0500000US05001,"Arkansas County, Arkansas",17761,9263,52.15%,47.85%,49.7,1033,5.82%,551,555,56,5317,1173,1331,691,10629,2022,5868,1728,1387,33.04%,9.73%,8%,636,16513,3.58%,96.42%,11575,4138,34,94,9,35,
0500000US05003,"Ashley County, Arkansas",20000,10341,51.71%,48.30%,55.7,1226,6.13%,806,603,47,6606,886,1241,422,11586,1663,7412,1489,1288,37.06%,7.45%,6%,1114,17948,5.57%,94.43%,12685,4644,25,41,6,32,
0500000US05005,"Baxter County, Arkansas",41673,21432,51.43%,48.57%,58,1610,3.86%,957,878,65,11248,3262,3773,1916,28449,5689,12205,4140,3838,29.29%,9.93%,9%,1058,40569,2.54%,97.46%,38049,88,218,234,9,94,
0500000US05007,"Benton County, Arkansas",273510,137412,50.24%,49.76%,58.3,8814,3.22%,8411,8787,2392,51801,11233,41516,20519,160716,62035,60212,20020,43908,22.01%,7.32%,16%,50540,233793,18.48%,81.52%,191761,4523,3799,13602,2598,861,
0500000US05009,"Boone County, Arkansas",37525,19021,50.69%,49.31%,57,1994,5.31%,1057,995,102,9032,2422,2976,1705,23191,4681,10089,3417,3078,26.89%,9.11%,8%,973,36400,2.59%,97.41%,33753,96,265,233,27,82,
0500000US05011,"Bradley County, Arkansas",10805,5703,52.78%,47.22%,50,818,7.57%,241,199,31,3219,541,761,279,6268,1040,3460,740,792,32.02%,6.85%,7%,1575,8970,14.58%,85.42%,5708,2921,29,27,0,13,
0500000US05013,"Calhoun County, Arkansas",5160,2579,49.98%,50.02%,45.3,383,7.42%,164,179,43,1711,385,212,192,3168,404,1875,564,255,36.34%,10.93%,5%,127,4612,2.46%,97.54%,3499,913,3,5,9,4,
0500000US05015,"Carroll County, Arkansas",28062,14084,50.19%,49.81%,55.2,1683,6.00%,850,556,104,7140,1187,2785,1431,17142,4216,7990,1743,2889,28.47%,6.21%,10%,4306,23954,15.34%,84.66%,21175,88,253,564,432,94,
0500000US05017,"Chicot County, Arkansas",10433,5266,50.47%,49.53%,43.5,1504,14.42%,435,273,2,2757,364,741,326,5697,1067,3192,637,743,30.60%,6.11%,7%,581,9627,5.57%,94.43%,3887,5387,26,38,9,25,
0500000US05019,"Clark County, Arkansas",22341,11754,52.61%,47.39%,42.4,2002,8.96%,1079,3402,340,4243,871,2154,1127,11592,3281,5322,4273,2494,23.82%,19.13%,11%,1092,20354,4.89%,95.11%,14093,5068,76,150,16,87,
0500000US05021,"Clay County, Arkansas",14710,7472,50.80%,49.21%,52.3,1075,7.31%,477,337,37,4336,841,751,674,8740,1425,4813,1178,788,32.72%,8.01%,5%,327,14225,2.22%,97.78%,13574,40,44,14,5,20,
0500000US05023,"Cleburne County, Arkansas",25063,12547,50.06%,49.94%,57.5,1356,5.41%,882,368,42,7639,1429,1947,1188,16219,3135,8521,1797,1989,34.00%,7.17%,8%,632,24079,2.52%,97.48%,22748,56,112,96,11,50,
0500000US05025,"Cleveland County, Arkansas",8063,4238,52.56%,47.44%,52.4,576,7.14%,200,132,26,2650,395,648,265,5142,913,2850,527,674,35.35%,6.54%,8%,182,7368,2.26%,97.74%,6429,675,21,7,1,12,
0500000US05027,"Columbia County, Arkansas",23620,12268,51.94%,48.06%,44.8,2994,12.68%,1190,2492,185,6091,613,1894,1098,12678,2992,7281,3105,2079,30.83%,13.15%,9%,773,22028,3.27%,96.73%,13236,7834,71,163,0,71,
0500000US05029,"Conway County, Arkansas",20895,10595,50.71%,49.29%,51.6,1196,5.72%,609,673,115,6001,1414,1955,626,12614,2581,6610,2087,2070,31.63%,9.99%,10%,886,19829,4.24%,95.76%,16148,2190,136,89,8,22,
0500000US05031,"Craighead County, Arkansas",109081,55837,51.19%,48.81%,48.2,7790,7.14%,2816,6644,1459,23627,5952,11739,7279,62777,19018,26443,12596,13198,24.24%,11.55%,12%,6727,104504,6.17%,93.83%,79137,18331,270,1684,54,278,
0500000US05033,"Crawford County, Arkansas",63118,32012,50.72%,49.28%,58,4788,7.59%,2144,1869,186,14913,4077,5516,2252,36039,7768,17057,5946,5702,27.02%,9.42%,9%,4567,55566,7.24%,92.76%,47627,857,1366,939,27,126,
0500000US05035,"Crittenden County, Arkansas",48381,25364,52.43%,47.57%,40,4533,9.37%,1516,1892,156,10602,2365,3613,1775,25853,5388,12118,4257,3769,25.05%,8.80%,8%,1428,46735,2.95%,97.05%,18948,25804,115,322,17,89,
0500000US05037,"Cross County, Arkansas",16576,8592,51.83%,48.17%,51.8,1015,6.12%,505,399,36,4610,756,937,744,9317,1681,5115,1155,973,30.86%,6.97%,6%,352,16481,2.12%,97.88%,12067,3651,38,102,5,43,
0500000US05039,"Dallas County, Arkansas",7114,3659,51.43%,48.57%,46.4,443,6.23%,277,157,33,2281,382,456,95,4368,551,2558,539,489,35.96%,7.58%,7%,201,6281,2.83%,97.17%,3425,2582,14,7,0,25,
0500000US05041,"Desha County, Arkansas",11538,6231,54.00%,46.00%,46.5,1332,11.54%,374,300,37,3482,270,804,278,6185,1082,3856,570,841,33.42%,4.94%,7%,773,10622,6.70%,93.30%,4732,5385,36,61,0,16,
0500000US05043,"Drew County, Arkansas",18263,9377,51.34%,48.66%,45,1764,9.66%,604,1624,219,4299,682,1740,894,10087,2634,4903,2306,1959,26.85%,12.63%,11%,656,16694,3.59%,96.41%,11148,4815,68,100,9,55,
0500000US05045,"Faulkner County, Arkansas",124800,64133,51.39%,48.61%,47.6,8646,6.93%,4246,11070,2447,23710,5729,15384,9438,71210,24822,27956,16799,17831,22.40%,13.46%,14%,6790,116708,5.44%,94.56%,92573,14274,562,1461,61,418,
0500000US05047,"Franklin County, Arkansas",17785,8940,50.27%,49.73%,50.3,1707,9.60%,777,437,87,5156,1085,1058,316,10483,1374,5933,1522,1145,33.36%,8.56%,6%,491,16606,2.76%,97.24%,15201,78,199,162,10,30,
0500000US05049,"Fulton County, Arkansas",12301,6276,51.02%,48.98%,53.9,804,6.54%,388,285,7,3302,634,699,482,7580,1181,3690,919,706,30.00%,7.47%,6%,154,11921,1.25%,98.75%,11201,27,66,35,0,16,
0500000US05051,"Garland County, Arkansas",99043,51575,52.07%,47.93%,48.1,6898,6.96%,3091,2634,599,22428,6111,10938,5454,64264,16392,25519,8745,11537,25.77%,8.83%,12%,7047,93133,7.12%,92.88%,77239,8034,623,960,71,297,
0500000US05053,"Grant County, Arkansas",18229,9196,50.45%,49.55%,54.6,722,3.96%,706,479,29,5044,850,1809,791,11531,2600,5750,1329,1838,31.54%,7.29%,10%,440,17518,2.41%,97.59%,16166,447,70,76,1,15,
0500000US05055,"Greene County, Arkansas",45197,23070,51.04%,48.96%,54.8,3429,7.59%,1430,1389,374,13483,1809,3541,1701,27007,5242,14913,3198,3915,33.00%,7.08%,9%,1596,44140,3.53%,96.47%,40509,926,138,181,287,104,
0500000US05057,"Hempstead County, Arkansas",21695,11670,53.79%,46.21%,49.6,1312,6.05%,758,708,93,5532,1375,1461,842,12061,2303,6290,2083,1554,28.99%,9.60%,7%,2953,17112,13.61%,86.39%,10558,5644,81,88,5,44,
0500000US05059,"Hot Spring County, Arkansas",33667,16004,47.54%,52.46%,52.4,1425,4.23%,853,954,187,9279,1917,2417,1284,21109,3701,10132,2871,2604,30.09%,8.53%,8%,1265,31775,3.76%,96.24%,26221,3450,165,114,11,75,
0500000US05061,"Howard County, Arkansas",13267,6939,52.30%,47.70%,48.4,1034,7.79%,322,478,19,3508,780,900,309,7541,1209,3830,1258,919,28.87%,9.48%,7%,1517,11268,11.43%,88.57%,7982,2626,82,62,4,21,
0500000US05063,"Independence County, Arkansas",37585,19123,50.88%,49.12%,53.8,2174,5.78%,836,2008,113,9320,1954,3171,1494,21569,4665,10156,3962,3284,27.02%,10.54%,9%,3258,34680,8.67%,91.33%,31511,830,133,340,30,93,
0500000US05065,"Izard County, Arkansas",13596,6448,47.43%,52.57%,51.5,507,3.73%,347,353,43,3696,934,1035,469,8481,1504,4043,1287,1078,29.74%,9.47%,8%,326,13251,2.40%,97.60%,12175,256,73,27,9,33,
0500000US05067,"Jackson County, Arkansas",16908,8535,50.48%,49.52%,40.3,1067,6.31%,747,332,69,5266,898,885,538,10124,1423,6013,1230,954,35.56%,7.27%,6%,461,16294,2.73%,97.27%,12754,2764,43,63,4,50,
0500000US05069,"Jefferson County, Arkansas",68123,34475,50.61%,49.39%,40.6,5687,8.35%,2991,2905,385,18542,2752,5489,2818,40354,8307,21533,5657,5874,31.61%,8.30%,9%,1488,65772,2.18%,97.82%,25230,37712,212,664,93,164,
0500000US05071,"Johnson County, Arkansas",26475,13476,50.90%,49.10%,53.2,1657,6.26%,898,1083,235,7231,783,1837,1042,13928,2879,8129,1866,2072,30.70%,7.05%,8%,3439,22310,12.99%,87.01%,19400,454,202,918,27,56,
0500000US05073,"Lafayette County, Arkansas",6728,3354,49.85%,50.15%,47.1,738,10.97%,215,186,82,2064,279,528,154,3836,682,2279,465,610,33.87%,6.91%,9%,145,6163,2.16%,97.84%,3870,2043,29,32,5,6,
0500000US05075,"Lawrence County, Arkansas",16511,8266,50.06%,49.94%,54.2,809,4.90%,696,674,101,4217,680,1097,529,9436,1626,4913,1354,1198,29.76%,8.20%,7%,357,15859,2.16%,97.84%,14925,138,41,38,10,33,
0500000US05077,"Lee County, Arkansas",8963,3870,43.18%,56.82%,35.7,1082,12.07%,386,174,9,2966,398,457,111,5113,568,3352,572,466,37.40%,6.38%,5%,216,8384,2.41%,97.59%,3424,4657,18,13,1,15,
0500000US05079,"Lincoln County, Arkansas",13278,4811,36.23%,63.77%,43.8,638,4.80%,471,191,103,4754,517,579,270,7910,849,5225,708,682,39.35%,5.33%,5%,619,12322,4.66%,95.34%,8188,3650,27,23,9,17,
0500000US05081,"Little River County, Arkansas",12345,6459,52.32%,47.68%,52.2,407,3.30%,398,327,21,3804,625,875,376,7860,1251,4202,952,896,34.04%,7.71%,7%,409,11617,3.31%,96.69%,8593,2164,161,19,9,20,
0500000US05083,"Logan County, Arkansas",21619,10970,50.74%,49.26%,54.3,1295,5.99%,609,641,62,6706,1199,1267,609,13296,1876,7315,1840,1329,33.84%,8.51%,6%,640,20491,2.96%,97.04%,18586,225,228,328,8,35,
0500000US05085,"Lonoke County, Arkansas",73163,37218,50.87%,49.13%,53.7,3157,4.32%,2323,1901,633,18306,4929,6962,3075,43886,10037,20629,6830,7595,28.20%,9.34%,10%,3610,70405,4.93%,95.07%,60596,4349,314,716,49,173,
0500000US05087,"Madison County, Arkansas",16393,8064,49.19%,50.81%,56.7,1065,6.50%,682,292,15,5604,574,835,550,9672,1385,6286,866,850,38.35%,5.28%,5%,890,15631,5.43%,94.57%,14075,36,205,102,238,59,
0500000US05089,"Marion County, Arkansas",16586,8554,51.57%,48.43%,53.8,1416,8.54%,352,265,66,4384,1050,1364,679,10909,2043,4736,1315,1430,28.55%,7.93%,9%,379,16447,2.29%,97.71%,15414,20,127,56,0,14,
0500000US05091,"Miller County, Arkansas",43515,22126,50.85%,49.15%,45.7,3474,7.98%,1683,1078,329,10251,1915,3322,2002,25369,5324,11934,2993,3651,27.43%,6.88%,8%,1583,41017,3.64%,96.36%,27593,10922,246,205,4,139,
0500000US05093,"Mississippi County, Arkansas",41396,21158,51.11%,48.89%,45.4,3066,7.41%,1961,934,138,10455,2238,2706,1498,22128,4204,12416,3172,2844,29.99%,7.66%,7%,1771,38914,4.28%,95.72%,22861,14251,67,242,3,98,
0500000US05095,"Monroe County, Arkansas",6879,3583,52.09%,47.91%,39.5,937,13.62%,168,178,23,2115,269,462,160,3894,622,2283,447,485,33.19%,6.50%,7%,186,6613,2.70%,97.30%,3538,2751,30,28,7,32,
0500000US05097,"Montgomery County, Arkansas",8964,4488,50.07%,49.93%,62,504,5.62%,249,190,0,2276,505,645,369,5596,1014,2525,695,645,28.17%,7.75%,7%,415,8069,4.63%,95.37%,7499,13,92,47,5,14,
0500000US05099,"Nevada County, Arkansas",8249,4111,49.84%,50.16%,48.3,369,4.47%,328,157,3,2809,486,445,234,5116,679,3137,643,448,38.03%,7.79%,5%,354,7956,4.29%,95.71%,5145,2433,37,41,0,16,
0500000US05101,"Newton County, Arkansas",7753,3922,50.59%,49.41%,55.5,331,4.27%,253,289,14,2110,382,609,283,4833,892,2363,671,623,30.48%,8.65%,8%,82,7143,1.06%,98.94%,6658,6,66,24,1,19,
0500000US05103,"Ouachita County, Arkansas",23597,12444,52.74%,47.26%,45.3,2097,8.89%,706,787,108,6662,1231,1452,758,14160,2210,7368,2018,1560,31.22%,8.55%,7%,516,22134,2.19%,97.81%,12092,8856,49,123,3,47,
0500000US05105,"Perry County, Arkansas",10342,5037,48.70%,51.30%,54.3,797,7.71%,198,311,24,3071,445,956,356,6574,1312,3269,756,980,31.61%,7.31%,9%,286,9733,2.77%,97.23%,9069,107,43,12,0,25,
0500000US05107,"Phillips County, Arkansas",18151,9623,53.02%,46.98%,40.7,2622,14.45%,531,582,126,3726,1163,1263,587,9740,1850,4257,1745,1389,23.45%,9.61%,8%,264,16304,1.45%,98.55%,5541,10305,38,64,4,19,
0500000US05109,"Pike County, Arkansas",10714,5432,50.70%,49.30%,59.8,528,4.93%,385,384,49,2779,526,889,486,6387,1375,3164,910,938,29.53%,8.49%,9%,831,9340,7.76%,92.24%,8525,238,83,16,0,26,
0500000US05111,"Poinsett County, Arkansas",23747,12161,51.21%,48.79%,50.7,1620,6.82%,745,740,59,7256,720,1341,525,13068,1866,8001,1460,1400,33.69%,6.15%,6%,829,22136,3.49%,96.51%,19163,1773,91,56,1,50,
0500000US05113,"Polk County, Arkansas",19999,10252,51.26%,48.74%,53.5,1153,5.77%,659,453,48,5068,1093,1370,775,11943,2145,5727,1546,1418,28.64%,7.73%,7%,1278,17943,6.39%,93.61%,16092,39,335,100,9,54,
0500000US05115,"Pope County, Arkansas",63926,32379,50.65%,49.35%,47.7,3413,5.34%,2520,5002,581,13871,2700,6779,3299,34778,10078,16391,7702,7360,25.64%,12.05%,12%,6415,56966,10.04%,89.96%,50037,2060,456,664,23,177,
0500000US05117,"Prairie County, Arkansas",8138,4137,50.84%,49.16%,53.9,391,4.80%,215,174,117,2306,452,655,247,5079,902,2521,626,772,30.98%,7.69%,9%,145,8137,1.78%,98.22%,6924,922,19,20,3,11,
0500000US05119,"Pulaski County, Arkansas",393078,205618,52.31%,47.69%,43,29267,7.45%,11516,12184,5422,69598,20420,56485,37661,244406,94146,81114,32604,61907,20.64%,8.29%,16%,33153,365972,8.43%,91.57%,193993,142139,1169,9933,208,1458,
0500000US05121,"Randolph County, Arkansas",17934,8927,49.78%,50.22%,52.7,1149,6.41%,526,413,21,4466,1370,1096,617,10502,1713,4992,1783,1117,27.84%,9.94%,6%,384,18187,2.14%,97.86%,16553,140,84,73,595,26,
0500000US05123,"St. Francis County, Arkansas",25477,11216,44.02%,55.98%,37.8,2585,10.15%,503,903,21,6533,1592,1138,812,14604,1950,7036,2495,1159,27.62%,9.79%,5%,686,22404,2.69%,97.31%,9206,12501,65,122,0,35,
0500000US05125,"Saline County, Arkansas",120990,61832,51.11%,48.90%,54.8,4081,3.37%,3459,3312,488,26022,7765,15614,7610,76720,23224,29481,11077,16102,24.37%,9.16%,13%,8507,114909,7.03%,92.97%,96745,10351,522,1453,70,331,
0500000US05127,"Scott County, Arkansas",10269,4860,47.33%,52.67%,61.8,572,5.57%,313,177,14,2900,494,597,271,5707,868,3213,671,611,31.29%,6.53%,6%,748,9088,7.28%,92.72%,8031,31,183,275,5,31,
0500000US05129,"Searcy County, Arkansas",7898,3950,50.01%,49.99%,59.2,461,5.84%,295,213,24,2367,462,454,171,4614,625,2662,675,478,33.70%,8.55%,6%,140,7688,1.77%,98.23%,7092,5,65,20,5,15,
0500000US05131,"Sebastian County, Arkansas",127670,65220,51.09%,48.92%,49.8,8266,6.47%,4980,4741,572,25209,6362,12853,7015,71913,19868,30189,11103,13425,23.65%,8.70%,11%,19328,108471,15.14%,84.86%,82785,7891,2379,5700,91,299,
0500000US05133,"Sevier County, Arkansas",16947,8359,49.32%,50.68%,54.9,1019,6.01%,434,684,107,3871,756,907,517,8043,1424,4305,1440,1014,25.40%,8.50%,6%,5508,10331,32.50%,67.50%,8400,550,305,60,241,21,
0500000US05135,"Sharp County, Arkansas",17217,8769,50.93%,49.07%,53.1,987,5.73%,439,438,46,5041,830,874,437,10471,1311,5480,1268,920,31.83%,7.36%,5%,362,16909,2.10%,97.90%,15729,114,121,57,20,24,
0500000US05137,"Stone County, Arkansas",12582,6371,50.64%,49.36%,50,745,5.92%,277,329,28,3166,1049,871,303,7389,1174,3443,1378,899,27.36%,10.95%,7%,271,12088,2.15%,97.85%,11387,21,87,25,2,30,
0500000US05139,"Union County, Arkansas",39089,20264,51.84%,48.16%,47.3,3420,8.75%,1101,1180,328,9203,2361,3831,1797,22928,5628,10304,3541,4159,26.36%,9.06%,11%,1754,37300,4.49%,95.51%,22904,12670,108,273,16,116,
0500000US05141,"Van Buren County, Arkansas",16578,8396,50.65%,49.36%,54.4,930,5.61%,594,271,61,5055,895,1140,798,10380,1938,5649,1166,1201,34.08%,7.03%,7%,501,15295,3.02%,96.98%,14319,71,110,56,0,15,
0500000US05143,"Washington County, Arkansas",236198,117983,49.95%,50.05%,47.3,17288,7.32%,8788,19399,3580,38266,8622,27859,20047,123268,47906,47054,28021,31439,19.92%,11.86%,13%,44755,201116,18.95%,81.05%,160566,8330,2443,5631,8734,729,
0500000US05145,"White County, Arkansas",78725,40212,51.08%,48.92%,49.8,4533,5.76%,2589,5091,711,20699,4011,6262,4363,43929,10625,23288,9102,6973,29.58%,11.56%,9%,3499,73323,4.44%,95.56%,64363,3677,319,616,25,214,
0500000US05147,"Woodruff County, Arkansas",6477,3472,53.61%,46.40%,52.9,738,11.39%,171,211,31,1990,385,407,286,3791,693,2161,596,438,33.36%,9.20%,7%,96,6173,1.48%,98.52%,4235,1601,8,22,0,25,
0500000US05149,"Yell County, Arkansas",21425,10587,49.41%,50.59%,52.3,1426,6.66%,751,764,32,5764,726,1288,656,11415,1944,6515,1490,1320,30.41%,6.95%,6%,4204,16059,19.62%,80.38%,14710,226,111,202,11,29,
0500000US06001,"Alameda County, California",1661584,844443,50.82%,49.18%,48.6,76379,4.60%,39892,62546,23341,201032,75950,332539,243188,1050689,575727,240924,138496,355880,14.50%,8.34%,21%,393749,1288604,23.70%,76.30%,472277,159499,4131,540511,13209,10440,
0500000US06003,"Alpine County, California",1159,540,46.59%,53.41%,57,55,4.75%,4,15,6,251,49,173,163,834,336,255,64,179,22.00%,5.52%,15%,84,1120,7.25%,92.75%,801,10,214,12,0,7,
0500000US06005,"Amador County, California",39023,17944,45.98%,54.02%,50.8,1619,4.15%,742,985,0,9228,4138,3797,1776,28086,5573,9970,5123,3797,25.55%,13.13%,10%,6014,34460,15.41%,84.59%,29725,1215,577,554,73,249,
0500000US06007,"Butte County, California",223344,112953,50.57%,49.43%,42.1,19418,8.69%,9416,16510,3763,32993,15343,26874,14509,131093,41383,42409,31853,30637,18.99%,14.26%,14%,40112,171520,17.96%,82.04%,139651,3320,3050,10333,508,1184,
0500000US06009,"Calaveras County, California",45828,22919,50.01%,49.99%,53.8,2490,5.43%,706,1641,170,10270,4238,4774,2237,31726,7011,10976,5879,4944,23.95%,12.83%,11%,5865,39427,12.80%,87.20%,34668,334,497,706,75,268,
0500000US06011,"Colusa County, California",21491,10498,48.85%,51.15%,49.7,901,4.19%,647,997,23,3909,1350,1577,464,9993,2041,4556,2347,1600,21.20%,10.92%,7%,13476,8363,62.71%,37.29%,6941,182,280,252,70,92,
0500000US06013,"Contra Costa County, California",1147788,586593,51.11%,48.89%,51.8,45167,3.94%,28570,42451,12284,136954,67290,212718,131526,714303,344244,165524,109741,225002,14.42%,9.56%,20%,314900,851027,27.44%,72.56%,455421,97994,2553,214520,5720,8366,
0500000US06015,"Del Norte County, California",27692,12947,46.75%,53.25%,43.8,2199,7.94%,757,677,26,6265,1612,1870,1172,15758,3042,7022,2289,1896,25.36%,8.27%,7%,5321,22422,19.21%,80.79%,16262,841,2136,826,28,122,
0500000US06017,"El Dorado County, California",190345,95572,50.21%,49.79%,56.9,6942,3.65%,5315,5586,1087,29309,15984,32856,16163,130793,49019,34624,21570,33943,18.19%,11.33%,18%,26459,164726,13.90%,86.10%,140141,1436,1273,9024,276,1215,
0500000US06019,"Fresno County, California",990204,496148,50.11%,49.89%,44.5,87576,8.84%,30933,47143,6746,138139,55709,89315,45296,472113,134611,169072,102852,96061,17.07%,10.39%,10%,540743,467911,54.61%,45.39%,271889,44295,6074,109665,1233,5209,
0500000US06021,"Glenn County, California",28060,13692,48.80%,51.21%,54.8,1647,5.87%,890,1149,77,4970,1640,2054,556,13457,2610,5860,2789,2131,20.88%,9.94%,8%,12541,16376,44.69%,55.31%,13897,140,531,626,39,144,
0500000US06023,"Humboldt County, California",136101,68563,50.38%,49.62%,38.4,12657,9.30%,4498,10315,1130,21408,9946,19270,9500,84375,28770,25906,20261,20400,19.03%,14.89%,15%,18535,117928,13.62%,86.38%,93316,1729,7454,3495,436,1091,
0500000US06025,"Imperial County, California",180580,87971,48.72%,51.28%,42.2,15963,8.84%,4644,9966,673,28189,7158,12186,4807,77535,16993,32833,17124,12859,18.18%,9.48%,7%,153027,26675,84.74%,15.26%,16813,3846,1584,2244,82,519,
0500000US06027,"Inyo County, California",17930,8691,48.47%,51.53%,48.9,823,4.59%,626,328,44,4059,1140,2161,1305,11900,3466,4685,1468,2205,26.13%,8.19%,12%,4399,14617,24.53%,75.47%,11035,85,2189,273,13,87,
0500000US06029,"Kern County, California",892458,435215,48.77%,51.23%,46.1,75627,8.47%,36710,36008,4186,149716,42354,61882,31238,409715,93120,186426,78362,66068,20.89%,8.78%,7%,499158,410077,55.93%,44.07%,279600,46776,5197,44257,1127,4557,
0500000US06031,"Kings County, California",151090,67880,44.93%,55.07%,46.8,10012,6.63%,7521,5736,970,24561,7942,9431,4637,69196,14068,32082,13678,10401,21.23%,9.05%,7%,86607,65879,57.32%,42.68%,44361,8300,1690,5511,331,713,
0500000US06033,"Lake County, California",64276,32177,50.06%,49.94%,44.5,5290,8.23%,1393,2309,97,14004,5441,5159,2611,40079,7770,15397,7750,5256,23.95%,12.06%,8%,15442,52721,24.02%,75.98%,44202,1158,1737,940,89,386,
0500000US06035,"Lassen County, California",30600,10558,34.50%,65.50%,43.4,1102,3.60%,1346,927,60,7127,1830,2033,792,17976,2825,8473,2757,2093,27.69%,9.01%,7%,7531,25199,24.61%,75.39%,19534,2244,939,472,283,142,
0500000US06037,"Los Angeles County, California",10040682,5091117,50.71%,49.30%,42.9,596705,5.94%,268461,462999,117387,1406963,485887,1506714,810968,5513270,2317682,1675424,948886,1624101,16.69%,9.45%,16%,4804763,5209246,47.85%,52.15%,2563609,760689,18453,1474237,20522,58683,
0500000US06039,"Madera County, California",155925,80618,51.70%,48.30%,49,10628,6.82%,5187,6451,678,22864,7405,10572,4340,70513,14912,28051,13856,11250,17.99%,8.89%,7%,93178,63077,59.76%,40.24%,48399,4131,1738,3581,122,723,
0500000US06041,"Marin County, California",259441,132912,51.23%,48.77%,52.4,8331,3.21%,4882,6999,3127,19534,11784,65503,49101,178366,114604,24416,18783,68630,9.41%,7.24%,26%,49410,212911,19.04%,80.96%,173149,6120,555,16175,457,2040,
0500000US06043,"Mariposa County, California",17319,8389,48.44%,51.56%,51.3,1222,7.06%,393,419,11,3073,1510,2440,1219,12365,3659,3466,1929,2451,20.01%,11.14%,14%,2140,14991,12.36%,87.64%,12838,105,410,287,15,114,
0500000US06045,"Mendocino County, California",87110,44003,50.51%,49.49%,45.1,5207,5.98%,2393,2901,314,16306,5300,9143,5734,53753,14877,18699,8201,9457,21.47%,9.41%,11%,23933,67668,27.47%,72.53%,56205,607,3528,1730,110,592,
0500000US06047,"Merced County, California",273661,135433,49.49%,50.51%,45.2,22411,8.19%,8825,16141,2223,41355,12650,15580,7293,113189,22873,50180,28791,17803,18.34%,10.52%,7%,173857,107345,63.53%,36.47%,68729,8191,1164,19824,617,1242,
0500000US06049,"Modoc County, California",8853,4349,49.13%,50.88%,54,467,5.28%,215,76,7,2132,616,821,399,5679,1220,2347,692,828,26.51%,7.82%,9%,1259,7441,14.22%,85.78%,6446,66,387,61,13,56,
0500000US06051,"Mono County, California",14395,6688,46.46%,53.54%,39.6,933,6.48%,469,813,65,2195,968,2152,1056,8819,3208,2664,1781,2217,18.51%,12.37%,15%,3507,9688,24.36%,75.64%,8679,68,177,159,26,78,
0500000US06053,"Monterey County, California",432977,212558,49.09%,50.91%,47.5,20436,4.72%,12576,20703,2798,55464,23230,43698,28894,201883,72592,68040,43933,46496,15.71%,10.15%,11%,265321,173714,61.28%,38.72%,120077,9051,1314,25123,1859,2170,
0500000US06055,"Napa County, California",138572,69522,50.17%,49.83%,50.3,4551,3.28%,4196,5863,906,17192,8718,23922,12537,83844,36459,21388,14581,24828,15.43%,10.52%,18%,48829,89190,35.24%,64.76%,68909,2300,507,10520,316,910,
0500000US06057,"Nevada County, California",99417,50474,50.77%,49.23%,53.2,4565,4.59%,2084,2856,301,13997,8235,18883,9865,72375,28748,16081,11091,19184,16.18%,11.16%,19%,10416,91825,10.48%,89.52%,82810,416,695,1371,119,617,
0500000US06059,"Orange County, California",3170345,1605768,50.65%,49.35%,50,149894,4.73%,85378,141233,37697,376248,171104,575866,324541,1878164,900407,461626,312337,613563,14.56%,9.85%,19%,1086834,2100155,34.28%,65.72%,1198655,49304,5298,699124,7714,14818,
0500000US06061,"Placer County, California",391799,200408,51.15%,48.85%,56.4,14164,3.62%,9264,13623,3471,48431,30740,74031,38491,262387,112522,57695,44363,77502,14.73%,11.32%,20%,60628,344111,15.47%,84.53%,272471,6440,2010,34776,967,2091,
0500000US06063,"Plumas County, California",18844,9396,49.86%,50.14%,51.2,942,5.00%,379,532,46,3505,1727,2273,1293,13774,3566,3884,2259,2319,20.61%,11.99%,12%,1897,17893,10.07%,89.93%,15999,102,382,145,40,114,
0500000US06065,"Riverside County, California",2437864,1222631,50.15%,49.85%,48.6,130036,5.33%,93512,103298,15596,423434,131588,236902,132238,1314063,369140,516946,234886,252498,21.20%,9.63%,10%,1202295,1215890,49.32%,50.68%,788235,146762,11960,164889,6767,12365,
0500000US06067,"Sacramento County, California",1537948,785850,51.10%,48.90%,46,93753,6.10%,44940,59171,12748,230733,101801,214265,113786,917323,328051,275673,160972,227013,17.92%,10.47%,15%,374434,1210621,24.35%,75.65%,650271,145724,7432,276295,18011,10104,
0500000US06069,"San Benito County, California",61547,30562,49.66%,50.34%,51.5,2145,3.49%,2022,2683,296,10319,3911,5857,2184,32735,8041,12341,6594,6153,20.05%,10.71%,10%,39241,24968,63.76%,36.24%,19785,479,221,2189,127,332,
0500000US06071,"San Bernardino County, California",2162532,1085931,50.22%,49.78%,45.9,134493,6.22%,82739,98212,16705,361289,118673,190544,101693,1104243,292237,444028,216885,207249,20.53%,10.03%,10%,1170913,1010741,54.15%,45.85%,566113,173322,8412,176204,6173,12117,
0500000US06073,"San Diego County, California",3323970,1649458,49.62%,50.38%,47.7,166703,5.02%,115338,156584,40649,412620,189078,547105,346543,1994138,893648,527958,345662,587754,15.88%,10.40%,18%,1119629,2179005,33.68%,66.32%,1422205,145014,12841,400589,12991,18125,
0500000US06075,"San Francisco County, California",874784,428538,48.99%,51.01%,39.7,43181,4.94%,12038,22871,23031,80686,35583,244101,165240,616833,409341,92724,58454,267132,10.60%,6.68%,31%,136761,737204,15.63%,84.37%,341306,45071,1570,294220,3244,6347,
0500000US06077,"San Joaquin County, California",751615,376974,50.16%,49.85%,47.5,44190,5.88%,28012,29146,5521,135093,44771,61634,29474,380893,91108,163105,73917,67155,21.70%,9.83%,9%,325725,453508,43.34%,56.66%,215530,56898,3135,134684,4977,4192,
0500000US06079,"San Luis Obispo County, California",282517,139582,49.41%,50.59%,47.6,16501,5.84%,9652,27063,4318,37867,19894,42392,26143,174460,68535,47519,46957,46710,16.82%,16.62%,17%,67921,214503,24.04%,75.96%,183468,4330,1136,10001,340,1614,
0500000US06081,"San Mateo County, California",765623,386376,50.47%,49.53%,52.6,23321,3.05%,15410,22260,13381,82274,37851,162985,124897,499931,287882,97684,60111,176366,12.76%,7.85%,23%,191386,573056,25.00%,75.00%,275902,14701,1021,227783,8840,5840,
0500000US06083,"Santa Barbara County, California",444895,222371,49.98%,50.02%,45,28412,6.39%,14615,42418,6835,46722,23042,57549,38998,225959,96547,61337,65460,64384,13.79%,14.71%,14%,210584,237645,47.33%,52.67%,184746,6467,1731,25378,542,2378,
0500000US06085,"Santa Clara County, California",1924379,949638,49.35%,50.65%,52.8,67602,3.51%,43639,69638,34511,187777,90144,374303,342631,1189749,716934,231416,159782,408814,12.03%,8.30%,21%,487357,1448902,25.33%,74.67%,555708,42148,3240,753399,5945,10195,
0500000US06087,"Santa Cruz County, California",273170,137937,50.50%,49.51%,44.1,15522,5.68%,9973,23865,3991,28141,15258,43990,31445,159224,75435,38114,39123,47981,13.95%,14.32%,18%,94299,176562,34.52%,65.48%,145551,2850,853,12072,277,1649,
0500000US06089,"Shasta County, California",179267,91115,50.83%,49.17%,50.4,11445,6.38%,5220,5991,787,32500,14473,18808,9289,115714,28097,37720,20464,19595,21.04%,11.42%,11%,19730,162425,11.01%,88.99%,136894,1761,4047,5839,323,1037,
0500000US06091,"Sierra County, California",2898,1424,49.14%,50.86%,53.7,66,2.28%,49,88,15,617,220,202,244,2130,446,666,308,217,22.98%,10.63%,7%,377,2859,13.01%,86.99%,2615,7,18,7,1,25,
0500000US06093,"Siskiyou County, California",43516,21858,50.23%,49.77%,50.4,3348,7.69%,875,1498,70,8182,3752,4593,2435,28584,7028,9057,5250,4663,20.81%,12.06%,11%,5527,38549,12.70%,87.30%,32057,471,1757,866,38,265,
0500000US06095,"Solano County, California",444538,223308,50.23%,49.77%,49,18132,4.08%,13837,18100,2606,72495,32315,56808,26333,272472,83141,86332,50415,59414,19.42%,11.34%,13%,128155,325336,28.83%,71.17%,155125,60051,1624,70953,3775,2988,
0500000US06097,"Sonoma County, California",496801,254144,51.16%,48.84%,48.7,22641,4.56%,12859,18797,4016,65471,34294,82070,48764,320080,130834,78330,53091,86086,15.77%,10.69%,17%,141438,347425,28.47%,71.53%,285792,7125,3053,22239,1708,2909,
0500000US06099,"Stanislaus County, California",546235,275703,50.47%,49.53%,48.2,30632,5.61%,20452,23114,2350,103320,26138,42776,18536,276237,61312,123772,49252,45126,22.66%,9.02%,8%,265978,286900,48.69%,51.31%,207908,14302,2621,33169,3713,2734,
0500000US06101,"Sutter County, California",96315,48225,50.07%,49.93%,52.1,5494,5.70%,2720,3724,306,14528,6699,8301,4335,50358,12636,17248,10423,8607,17.91%,10.82%,9%,31568,68065,32.78%,67.22%,41366,1774,862,18014,279,611,
0500000US06103,"Tehama County, California",64176,32327,50.37%,49.63%,51,5837,9.10%,1852,1690,300,12626,4454,5566,2132,37934,7698,14478,6144,5866,22.56%,9.57%,9%,17938,47891,27.95%,72.05%,41340,391,1167,985,96,324,
0500000US06105,"Trinity County, California",12541,6172,49.22%,50.79%,46.6,1592,12.69%,278,312,52,3540,764,1223,645,9039,1868,3818,1076,1275,30.44%,8.58%,10%,937,15175,7.47%,92.53%,11374,66,416,2212,24,106,
0500000US06107,"Tulare County, California",463955,231997,50.00%,50.00%,47.3,39492,8.51%,16816,21976,1641,72791,23213,26811,13036,197252,39847,89607,45189,28452,19.31%,9.74%,6%,309895,163222,66.79%,33.21%,125022,5332,3458,15997,511,2132,
0500000US06109,"Tuolumne County, California",54147,26124,48.25%,51.75%,48.5,2280,4.21%,1349,1662,101,10643,4394,6019,3233,37688,9252,11992,6056,6120,22.15%,11.18%,11%,7124,48496,13.16%,86.84%,42254,989,784,770,110,313,
0500000US06111,"Ventura County, California",845599,427008,50.50%,49.50%,49.2,31382,3.71%,24102,38937,7382,111720,57785,123510,70729,490833,194239,135822,96722,130892,16.06%,11.44%,15%,365285,478558,43.20%,56.80%,360850,13704,2020,63252,1415,4451,
0500000US06113,"Yolo County, California",218774,112772,51.55%,48.45%,44,23881,10.92%,10602,25712,5688,22703,9547,28050,26773,112513,54823,33305,35259,33738,15.22%,16.12%,15%,71700,144703,32.77%,67.23%,93911,5722,948,29872,1079,1278,
0500000US06115,"Yuba County, California",77524,38177,49.25%,50.76%,49.6,5630,7.26%,2521,3732,358,11651,5197,6196,2619,40218,8815,14172,8929,6554,18.28%,11.52%,8%,23520,58055,30.34%,69.66%,41750,2831,1034,5583,372,459,
0500000US08001,"Adams County, Colorado",509844,252459,49.52%,50.48%,48.6,23074,4.53%,17944,14146,3819,95616,29721,57010,25990,279480,83000,113560,43867,60829,22.27%,8.60%,12%,216649,302923,42.49%,57.51%,239295,16054,2869,22583,753,2369,
0500000US08003,"Alamosa County, Colorado",16153,8166,50.55%,49.45%,46.5,922,5.71%,685,1186,240,2749,977,1384,1001,8499,2385,3434,2163,1624,21.26%,13.39%,10%,7701,8675,47.68%,52.32%,7490,211,215,142,19,104,
0500000US08005,"Arapahoe County, Colorado",649980,327716,50.42%,49.58%,50.1,21512,3.31%,17423,19425,8221,90643,38298,121422,71401,409866,192823,108066,57723,129643,16.63%,8.88%,20%,135729,519341,20.88%,79.12%,368047,68152,2654,41855,1634,3549,
0500000US08007,"Archuleta County, Colorado",13588,6879,50.63%,49.37%,64.5,624,4.59%,322,299,19,2201,708,2656,1459,9763,4115,2523,1007,2675,18.57%,7.41%,20%,2159,11200,15.89%,84.11%,10175,41,170,101,6,77,
0500000US08009,"Baca County, Colorado",3570,1780,49.86%,50.14%,59.2,169,4.73%,51,132,0,787,295,427,150,2260,577,838,427,427,23.47%,11.96%,12%,346,3160,9.69%,90.31%,2916,19,38,8,0,37,
0500000US08011,"Bent County, Colorado",5677,2139,37.68%,62.32%,45.8,361,6.36%,163,145,37,2162,254,392,271,3871,663,2325,399,429,40.95%,7.03%,8%,1760,3890,31.00%,69.00%,3315,255,90,39,0,8,
0500000US08013,"Boulder County, Colorado",324682,161339,49.69%,50.31%,45.8,21748,6.70%,9797,26729,7850,24414,13861,74561,61315,206124,135876,34211,40590,82411,10.54%,12.50%,25%,48168,282590,14.84%,85.16%,245203,3149,1112,16291,241,1820,
0500000US08014,"Broomfield County, Colorado",69444,34740,50.03%,49.97%,54.1,1696,2.44%,1664,1798,1118,6741,4229,16900,10260,46910,27160,8405,6027,18018,12.10%,8.68%,26%,9919,64193,14.28%,85.72%,53904,927,197,5096,80,351,
0500000US08015,"Chaffee County, Colorado",19977,9437,47.24%,52.76%,56.9,867,4.34%,510,175,119,4238,1347,3405,2265,15015,5670,4748,1522,3524,23.77%,7.62%,18%,1841,17635,9.22%,90.78%,16195,295,132,133,11,100,
0500000US08017,"Cheyenne County, Colorado",1999,1043,52.18%,47.82%,67.7,93,4.65%,12,29,0,376,168,271,45,1276,316,388,197,271,19.41%,9.85%,14%,206,1542,10.31%,89.69%,1470,1,5,3,0,3,
0500000US08019,"Clear Creek County, Colorado",9533,4701,49.31%,50.69%,46.2,230,2.41%,181,161,43,1513,491,2111,1677,7261,3788,1694,652,2154,17.77%,6.84%,23%,648,8749,6.80%,93.20%,8149,49,41,82,7,38,
0500000US08021,"Conejos County, Colorado",8130,4042,49.72%,50.28%,44.8,579,7.12%,299,246,17,1656,406,874,490,4692,1364,1955,652,891,24.05%,8.02%,11%,3779,3682,46.48%,53.52%,3465,14,44,21,2,24,
0500000US08023,"Costilla County, Colorado",3810,1816,47.66%,52.34%,46.1,383,10.05%,62,201,35,718,154,375,288,2354,663,780,355,410,20.47%,9.32%,11%,1988,1511,52.18%,47.82%,1234,33,34,55,0,13,
0500000US08025,"Crowley County, Colorado",5733,1864,32.51%,67.49%,36,323,5.63%,104,252,23,2050,480,216,144,3616,360,2154,732,239,37.57%,12.77%,4%,1608,4314,28.05%,71.95%,3438,510,151,69,2,5,
0500000US08027,"Custer County, Colorado",4941,2551,51.63%,48.37%,69.7,181,3.66%,172,85,12,865,384,870,458,3755,1328,1037,469,882,20.99%,9.49%,18%,178,4526,3.60%,96.40%,4212,10,42,22,0,45,
0500000US08029,"Delta County, Colorado",30758,15265,49.63%,50.37%,54,2253,7.32%,910,398,191,8256,1742,3288,1625,20295,4913,9166,2140,3479,29.80%,6.96%,11%,4329,26867,14.07%,85.93%,24907,121,121,236,9,192,
0500000US08031,"Denver County, Colorado",715878,357209,49.90%,50.10%,37.8,41659,5.82%,17057,22408,11585,89119,28844,161125,100327,463113,261452,106176,51252,172710,14.83%,7.16%,24%,199460,516062,27.86%,72.14%,388764,61098,3740,27198,1395,3746,
0500000US08033,"Dolores County, Colorado",1896,849,44.78%,55.22%,59.6,46,2.43%,25,0,14,581,109,248,163,1503,411,606,109,262,31.96%,5.75%,14%,176,2150,9.28%,90.72%,1950,18,36,6,4,5,
0500000US08035,"Douglas County, Colorado",344280,172188,50.01%,49.99%,61.7,6055,1.76%,7450,10833,4361,28252,17998,86805,47502,224473,134307,35702,28831,91166,10.37%,8.37%,26%,34110,323868,9.91%,90.09%,278770,4788,970,19807,290,1551,
0500000US08037,"Eagle County, Colorado",54960,25765,46.88%,53.12%,48.8,1763,3.21%,1630,1496,464,5564,4200,13441,6162,35304,19603,7194,5696,13905,13.09%,10.36%,25%,16858,38873,30.67%,69.33%,36202,296,118,712,27,187,
0500000US08039,"Elbert County, Colorado",26230,12980,49.49%,50.52%,60.2,654,2.49%,840,620,150,4649,2415,4443,1965,18095,6408,5489,3035,4593,20.93%,11.57%,18%,2067,23995,7.88%,92.12%,22185,123,116,184,21,123,
0500000US08041,"El Paso County, Colorado",710499,351646,49.49%,50.51%,53.1,30454,4.29%,26655,35730,7693,92493,52226,108353,70637,436791,178990,119148,87956,116046,16.77%,12.38%,16%,129984,600411,18.29%,81.71%,480484,40759,3816,21629,2750,4599,
0500000US08043,"Fremont County, Colorado",47725,19917,41.73%,58.27%,52.8,1813,3.80%,1352,706,131,14442,3268,4351,2549,33337,6900,15794,3974,4482,33.09%,8.33%,9%,6049,42890,12.67%,87.33%,37713,1809,691,332,30,234,
0500000US08045,"Garfield County, Colorado",59605,29176,48.95%,51.05%,58.3,2109,3.54%,1994,1410,363,10380,3892,8362,4313,35315,12675,12374,5302,8725,20.76%,8.90%,15%,19564,42121,32.82%,67.18%,38636,277,300,397,34,309,
0500000US08047,"Gilpin County, Colorado",6108,2809,45.99%,54.01%,53.1,202,3.31%,101,62,59,740,545,1203,962,4604,2165,841,607,1262,13.77%,9.94%,21%,380,5428,6.22%,93.78%,4952,32,36,85,4,37,
0500000US08049,"Grand County, Colorado",15536,7150,46.02%,53.98%,52,543,3.50%,454,212,171,3190,804,3050,1702,11259,4752,3644,1016,3221,23.46%,6.54%,21%,1533,14184,9.87%,90.13%,13435,59,56,83,17,73,
0500000US08051,"Gunnison County, Colorado",17119,7803,45.58%,54.42%,42.6,993,5.80%,851,1951,479,1913,623,4456,1772,10575,6228,2764,2574,4935,16.15%,15.04%,29%,1604,15314,9.37%,90.63%,14254,77,70,121,7,111,
0500000US08053,"Hinsdale County, Colorado",781,453,58.00%,42.00%,62.5,48,6.15%,0,4,0,107,41,197,89,627,286,107,45,197,13.70%,5.76%,25%,30,758,3.84%,96.16%,693,8,6,2,1,6,
0500000US08055,"Huerfano County, Colorado",6769,3321,49.06%,50.94%,53.9,530,7.83%,222,47,13,1423,609,809,434,4887,1243,1645,656,822,24.30%,9.69%,12%,2130,4690,31.47%,68.53%,4231,53,77,24,0,49,
0500000US08057,"Jackson County, Colorado",1316,638,48.48%,51.52%,57.3,37,2.81%,19,35,1,227,76,241,98,953,339,246,111,242,18.69%,8.43%,18%,138,1241,10.49%,89.51%,1161,0,12,2,2,5,
0500000US08059,"Jefferson County, Colorado",578795,290026,50.11%,49.89%,51.7,19018,3.29%,13932,18648,6422,83767,32318,124649,70599,398658,195248,97699,50966,131071,16.88%,8.81%,23%,91514,491396,15.81%,84.19%,435245,6653,2898,17694,464,2816,
0500000US08061,"Kiowa County, Colorado",1463,765,52.29%,47.71%,57.6,61,4.17%,29,76,11,279,123,142,51,888,193,308,199,153,21.05%,13.60%,10%,104,1342,7.11%,92.89%,1247,3,0,9,1,1,
0500000US08063,"Kit Carson County, Colorado",7246,3500,48.30%,51.70%,57.8,175,2.42%,241,149,19,1631,572,514,352,4417,866,1872,721,533,25.83%,9.95%,7%,1409,5678,19.45%,80.55%,5306,21,24,30,5,32,
0500000US08065,"Lake County, Colorado",7845,3467,44.19%,55.81%,43.9,509,6.49%,193,174,180,1342,467,1666,693,5186,2359,1535,641,1846,19.57%,8.17%,24%,2662,4774,33.93%,66.07%,4293,31,46,63,8,45,
0500000US08067,"La Plata County, Colorado",56138,27886,49.67%,50.33%,51.1,2587,4.61%,1528,2282,984,8466,3067,11228,6519,38681,17747,9994,5349,12212,17.80%,9.53%,22%,7008,48630,12.48%,87.52%,42392,182,2809,381,33,377,
0500000US08069,"Larimer County, Colorado",350523,175871,50.17%,49.83%,49.2,20407,5.82%,13220,24915,8597,43238,21580,65179,45577,223372,110756,56458,46495,73776,16.11%,13.26%,21%,44662,314404,12.74%,87.26%,282581,3448,1495,8365,265,1819,
0500000US08071,"Las Animas County, Colorado",14323,6828,47.67%,52.33%,50.8,1131,7.90%,270,793,36,3115,1464,1328,764,9471,2092,3385,2257,1364,23.63%,15.76%,10%,5632,8923,39.32%,60.68%,7965,183,145,108,12,87,
0500000US08073,"Lincoln County, Colorado",5608,2115,37.71%,62.29%,48.8,194,3.46%,170,20,2,2309,320,396,135,3783,531,2479,340,398,44.20%,6.06%,7%,809,4866,14.43%,85.57%,4252,275,61,40,22,21,
0500000US08075,"Logan County, Colorado",22282,9986,44.82%,55.18%,46.3,767,3.44%,819,1095,121,5767,1781,2131,1138,14357,3269,6586,2876,2252,29.56%,12.91%,10%,3511,18017,15.76%,84.24%,16337,753,161,119,17,52,
0500000US08077,"Mesa County, Colorado",152962,77457,50.64%,49.36%,49.1,8467,5.54%,4363,6413,1074,30053,9251,19214,9897,96215,29111,34416,15664,20288,22.50%,10.24%,13%,23278,132425,15.22%,84.78%,120749,1020,933,1613,188,889,
0500000US08079,"Mineral County, Colorado",853,455,53.34%,46.66%,64,13,1.52%,2,18,0,118,41,252,127,686,379,120,59,252,14.07%,6.92%,30%,47,818,5.51%,94.49%,775,0,4,3,0,0,
0500000US08081,"Moffat County, Colorado",13150,6386,48.56%,51.44%,51.9,1271,9.67%,435,296,8,3378,873,1299,596,7937,1895,3813,1169,1307,29.00%,8.89%,10%,2124,11168,16.15%,83.85%,10313,77,98,52,2,60,
0500000US08083,"Montezuma County, Colorado",26266,13309,50.67%,49.33%,54.6,1194,4.55%,787,648,106,5769,1491,3507,1947,16938,5454,6556,2139,3613,24.96%,8.14%,14%,3109,22740,11.84%,88.16%,18035,72,3166,128,24,107,
0500000US08085,"Montrose County, Colorado",42280,21406,50.63%,49.37%,61,2226,5.26%,1251,922,250,9786,2046,5011,2432,26951,7443,11037,2968,5261,26.10%,7.02%,12%,9027,33652,21.35%,78.65%,31126,159,262,334,26,183,
0500000US08087,"Morgan County, Colorado",28617,14008,48.95%,51.05%,57,1015,3.55%,1052,783,108,5761,1739,2274,929,14727,3203,6813,2522,2382,23.81%,8.81%,8%,10566,18545,36.92%,63.08%,16546,935,110,153,11,77,
0500000US08089,"Otero County, Colorado",18284,9315,50.95%,49.05%,48.7,1588,8.69%,517,679,102,3864,1581,1589,919,10877,2508,4381,2260,1691,23.96%,12.36%,9%,7702,10988,42.12%,57.88%,10013,134,112,98,28,103,
0500000US08091,"Ouray County, Colorado",4890,2490,50.92%,49.08%,61.5,187,3.82%,64,81,28,540,406,1203,756,3933,1959,604,487,1231,12.35%,9.96%,25%,292,4582,5.97%,94.03%,4308,16,16,28,2,24,
0500000US08093,"Park County, Colorado",18345,8652,47.16%,52.84%,61.6,685,3.73%,445,327,42,3905,1640,3344,1426,14311,4770,4350,1967,3386,23.71%,10.72%,18%,1235,16155,6.73%,93.27%,14902,89,118,99,9,94,
0500000US08095,"Phillips County, Colorado",4343,2002,46.10%,53.90%,60.3,115,2.65%,158,117,18,850,331,489,225,2460,714,1008,448,507,23.21%,10.32%,12%,1155,3375,26.59%,73.41%,3246,10,12,22,1,5,
0500000US08097,"Pitkin County, Colorado",17980,8460,47.05%,52.95%,40.5,626,3.48%,504,451,179,1934,801,5946,2513,13325,8459,2438,1252,6125,13.56%,6.96%,34%,1892,15466,10.52%,89.48%,14433,94,36,280,7,82,
0500000US08099,"Prowers County, Colorado",12035,5884,48.89%,51.11%,51.1,572,4.75%,493,500,62,1962,813,849,598,6268,1447,2455,1313,911,20.40%,10.91%,8%,4680,7319,38.89%,61.11%,6686,83,118,31,6,50,
0500000US08101,"Pueblo County, Colorado",167412,84987,50.77%,49.24%,44.6,11935,7.13%,5036,6140,862,34160,13359,17369,9017,104032,26386,39196,19499,18231,23.41%,11.65%,11%,69921,98241,41.77%,58.23%,85527,2995,1246,1562,138,944,
0500000US08103,"Rio Blanco County, Colorado",6369,3095,48.60%,51.41%,56,444,6.97%,265,247,14,1326,442,745,319,3943,1064,1591,689,759,24.98%,10.82%,12%,622,5907,9.77%,90.23%,5509,29,51,22,2,29,
0500000US08105,"Rio Grande County, Colorado",11300,5627,49.80%,50.20%,53.9,496,4.39%,289,484,31,2292,473,1330,670,6752,2000,2581,957,1361,22.84%,8.47%,12%,4609,6930,40.79%,59.21%,6261,51,137,36,4,56,
0500000US08107,"Routt County, Colorado",25317,12037,47.55%,52.46%,53.5,1096,4.33%,811,641,243,3276,1570,5999,3298,17987,9297,4087,2211,6242,16.14%,8.73%,25%,2200,22629,8.69%,91.31%,21242,153,67,169,35,92,
0500000US08109,"Saguache County, Colorado",6730,3374,50.13%,49.87%,57.3,287,4.26%,185,88,21,1544,445,619,484,4219,1103,1729,533,640,25.69%,7.92%,10%,2394,3974,35.57%,64.43%,3578,19,81,63,2,42,
0500000US08111,"San Juan County, Colorado",646,327,50.62%,49.38%,51.4,95,14.71%,7,15,0,156,47,111,58,484,169,163,62,111,25.23%,9.60%,17%,90,615,13.93%,86.07%,575,1,6,2,0,1,
0500000US08113,"San Miguel County, Colorado",8110,3887,47.93%,52.07%,51.7,345,4.25%,147,163,192,1185,302,2546,929,5948,3475,1332,465,2738,16.42%,5.73%,34%,882,7190,10.88%,89.12%,6757,20,47,55,0,44,
0500000US08115,"Sedgwick County, Colorado",2306,1181,51.21%,48.79%,56.6,101,4.38%,56,27,7,414,295,214,111,1413,325,470,322,221,20.38%,13.96%,10%,363,2041,15.74%,84.26%,1934,3,10,12,0,8,
0500000US08117,"Summit County, Colorado",30735,14285,46.48%,53.52%,46.8,1155,3.76%,699,943,71,3535,1307,8974,3682,22023,12656,4234,2250,9045,13.78%,7.32%,29%,5335,25720,17.36%,82.64%,23782,232,67,407,20,150,
0500000US08119,"Teller County, Colorado",24981,12424,49.73%,50.27%,56.9,1161,4.65%,453,635,153,4709,2341,3947,2881,18607,6828,5162,2976,4100,20.66%,11.91%,16%,1716,22994,6.87%,93.13%,21017,132,122,201,12,148,
0500000US08121,"Washington County, Colorado",4869,2287,46.97%,53.03%,61.7,226,4.64%,219,131,15,1077,353,498,214,3126,712,1296,484,513,26.62%,9.94%,11%,516,4301,10.60%,89.40%,4057,24,8,15,10,20,
0500000US08123,"Weld County, Colorado",315389,156213,49.53%,50.47%,53.3,15552,4.93%,11076,12243,1848,55497,18644,37280,19015,178345,56295,66573,30887,39128,21.11%,9.79%,12%,98462,230519,31.22%,68.78%,205881,4154,1327,5682,303,1305,
0500000US08125,"Yuma County, Colorado",10013,4940,49.34%,50.66%,63.1,573,5.72%,152,244,92,2011,679,901,479,5776,1380,2163,923,993,21.60%,9.22%,10%,2771,7217,27.67%,72.33%,6948,21,16,26,2,27,
0500000US09001,"Fairfield County, Connecticut",944306,484479,51.31%,48.70%,51.1,36383,3.85%,23969,34485,17968,134341,39623,174948,141065,582871,316013,158310,74108,192916,16.76%,7.85%,20%,205351,752068,21.75%,78.25%,552125,99992,858,50751,173,11232,
0500000US09003,"Hartford County, Connecticut",892153,458891,51.44%,48.56%,46.3,44753,5.02%,22704,33802,14570,163450,53141,135774,104595,561754,240369,186154,86943,150344,20.87%,9.75%,17%,166275,733223,18.64%,81.36%,523105,118154,1166,53325,172,5659,
0500000US09005,"Litchfield County, Connecticut",181143,91578,50.56%,49.44%,52,5861,3.24%,4294,5601,2029,40102,12443,28805,19494,126375,48299,44396,18044,30834,24.51%,9.96%,17%,14580,170606,8.05%,91.95%,155601,2957,268,3434,63,931,
0500000US09007,"Middlesex County, Connecticut",162742,83255,51.16%,48.84%,50.9,5042,3.10%,3729,6515,2938,29875,11136,28975,22170,113399,51145,33604,17651,31913,20.65%,10.85%,20%,11928,152317,7.33%,92.67%,131954,8001,214,4923,43,744,
0500000US09009,"New Haven County, Connecticut",855733,443329,51.81%,48.19%,44,43817,5.12%,28510,34938,13049,179781,43480,113619,101570,540269,215189,208291,78418,126668,24.34%,9.16%,15%,170081,694754,19.88%,80.12%,509688,110273,1413,36995,247,5953,
0500000US09011,"New London County, Connecticut",266868,133150,49.89%,50.11%,49.3,8570,3.21%,9597,11034,4045,53519,16309,34869,29787,174550,64656,63116,27343,38914,23.65%,10.25%,15%,30920,237635,11.59%,88.41%,194894,14422,1977,10633,215,1415,
0500000US09013,"Tolland County, Connecticut",150947,75248,49.85%,50.15%,47.8,5769,3.82%,5730,18760,2789,25535,8994,23091,17833,91460,40924,31265,27754,25880,20.71%,18.39%,17%,9699,140089,6.43%,93.57%,120021,5074,182,8438,44,636,
0500000US09015,"Windham County, Connecticut",116657,58931,50.52%,49.48%,46.7,5339,4.58%,3055,6680,979,28778,7910,11378,8027,72977,19405,31833,14590,12357,27.29%,12.51%,11%,14459,101959,12.39%,87.61%,91844,2064,326,1960,17,506,
0500000US10001,"Kent County, Delaware",179124,92811,51.81%,48.19%,45.8,9654,5.39%,5711,8394,1687,40027,10148,18299,11155,105686,29454,45738,18542,19986,25.53%,10.35%,11%,13981,167870,7.81%,92.19%,104845,45737,864,4362,107,1028,
0500000US10003,"New Castle County, Delaware",558306,288028,51.59%,48.41%,45.3,29948,5.36%,17565,22169,5380,117603,27957,81387,60301,356101,141688,135168,50126,86767,24.21%,8.98%,16%,63516,507203,11.38%,88.62%,303265,142388,893,35022,127,2555,
0500000US10005,"Sussex County, Delaware",230249,119120,51.74%,48.27%,55.1,9135,3.97%,5506,5164,1071,53368,16484,29406,21495,154240,50901,58874,21648,30477,25.57%,9.40%,13%,26793,210585,11.64%,88.36%,171741,24835,764,3014,70,1018,
0500000US11001,"District of Columbia, District of Columbia",701974,368837,52.54%,47.46%,29.1,58140,8.28%,20176,30162,18140,83347,14583,126808,173167,461175,299975,103523,44745,144948,14.75%,6.37%,21%,77652,611893,11.06%,88.94%,261771,282066,1277,33192,349,3753,
0500000US12001,"Alachua County, Florida",268105,138719,51.74%,48.26%,36.1,30960,11.55%,9826,33169,9925,33264,18564,37493,34963,152507,72456,43090,51733,47418,16.07%,19.30%,18%,33614,244854,12.54%,87.46%,160463,51171,562,17891,101,1668,
0500000US12003,"Baker County, Florida",28679,13346,46.54%,53.46%,46.1,1447,5.05%,1370,721,91,8090,1618,1883,896,16438,2779,9460,2339,1974,32.99%,8.16%,7%,973,27286,3.39%,96.61%,22185,3825,109,157,14,84,
0500000US12005,"Bay County, Florida",180076,90704,50.37%,49.63%,50.5,9825,5.46%,4639,5944,987,37710,15001,20148,11157,116274,31305,42349,20945,21135,23.52%,11.63%,12%,13846,161370,7.69%,92.31%,128348,17549,795,4068,194,720,
0500000US12007,"Bradford County, Florida",27723,12356,44.57%,55.43%,40.7,1949,7.03%,948,571,74,8410,1232,1280,803,15997,2083,9358,1803,1354,33.76%,6.50%,5%,1350,26953,4.87%,95.13%,20320,5427,58,135,12,97,
0500000US12009,"Brevard County, Florida",594001,303545,51.10%,48.90%,49.6,29002,4.88%,14896,17276,3967,118273,55965,85520,51389,408277,136909,133169,73241,89487,22.42%,12.33%,15%,67907,538705,11.43%,88.57%,430936,56498,1569,15587,482,3389,
0500000US12011,"Broward County, Florida",1942273,996226,51.29%,48.71%,43.2,109135,5.62%,47620,64880,16367,372575,134343,284566,172135,1232527,456701,420195,199223,300933,21.63%,10.26%,15%,608703,1335672,31.34%,68.66%,644230,517618,2917,74040,696,21389,
0500000US12013,"Calhoun County, Florida",14324,6404,44.71%,55.29%,39.5,615,4.29%,296,342,59,4452,759,709,245,8199,954,4748,1101,768,33.15%,7.69%,5%,622,13026,4.34%,95.66%,10490,1668,93,46,0,10,
0500000US12015,"Charlotte County, Florida",185926,95002,51.10%,48.90%,54.9,8631,4.64%,3889,3167,647,51546,13730,23167,13560,139967,36727,55435,16897,23814,29.82%,9.09%,13%,14079,172768,7.57%,92.43%,153700,8870,385,2566,63,782,
0500000US12017,"Citrus County, Florida",147938,75939,51.33%,48.67%,51.9,8142,5.50%,3399,2654,455,44939,11284,13674,8673,105801,22347,48338,13938,14129,32.67%,9.42%,10%,9241,144602,6.25%,93.75%,131477,3891,466,2412,43,517,
0500000US12019,"Clay County, Florida",215294,109230,50.74%,49.27%,54.9,10061,4.67%,7047,6143,1162,43953,17890,26258,12463,136327,38721,51000,24033,27420,23.69%,11.16%,13%,23134,195111,10.75%,89.25%,148986,25621,680,6626,363,1064,
0500000US12021,"Collier County, Florida",379345,192592,50.77%,49.23%,54.3,17144,4.52%,9103,9142,2637,76011,25006,61848,42064,255503,103912,85114,34148,64485,22.44%,9.00%,17%,102249,273503,26.95%,73.05%,235455,22554,551,5419,61,1502,
0500000US12023,"Columbia County, Florida",70898,34244,48.30%,51.70%,44.3,4091,5.77%,2447,1961,86,17888,4386,5106,2210,41728,7316,20335,6347,5192,28.68%,8.95%,7%,5063,64635,7.14%,92.86%,49096,11441,236,867,27,295,
0500000US12027,"DeSoto County, Florida",37371,16342,43.73%,56.27%,41.8,3975,10.64%,1410,630,187,11812,1351,2198,1086,20105,3284,13222,1981,2385,35.38%,5.30%,6%,10011,23965,26.79%,73.21%,18624,4203,80,189,8,80,
0500000US12029,"Dixie County, Florida",16740,7151,42.72%,57.28%,53.1,871,5.20%,367,495,16,6033,744,727,471,10003,1198,6400,1239,743,38.23%,7.40%,4%,688,16071,4.11%,95.89%,13750,1551,61,58,0,33,
0500000US12031,"Duval County, Florida",948651,488731,51.52%,48.48%,42.6,65550,6.91%,30644,34277,7918,182766,63975,134057,65491,585720,199548,213410,98252,141975,22.50%,10.36%,15%,112689,882878,11.88%,88.12%,492039,286344,2306,48652,960,6837,
0500000US12033,"Escambia County, Florida",316691,160114,50.56%,49.44%,42.3,16841,5.32%,11529,16127,4148,57510,25365,36968,21311,193591,58279,69039,41492,41116,21.80%,13.10%,13%,20793,301112,6.57%,93.43%,200962,68148,1998,9866,410,1771,
0500000US12035,"Flagler County, Florida",112854,58904,52.20%,47.81%,55.3,6207,5.50%,3104,2386,543,28306,8862,14156,8081,79470,22237,31410,11248,14699,27.83%,9.97%,13%,12299,103079,10.90%,89.10%,84291,10537,291,2450,59,704,
0500000US12037,"Franklin County, Florida",11914,5210,43.73%,56.27%,45.1,1044,8.76%,345,192,7,3362,652,1103,797,7543,1900,3707,844,1110,31.11%,7.08%,9%,675,11776,5.67%,94.33%,9798,1403,41,30,2,41,
0500000US12039,"Gadsden County, Florida",45787,23989,52.39%,47.61%,40.5,4723,10.32%,1857,697,204,11719,1982,3821,2019,26179,5840,13576,2679,4025,29.65%,5.85%,9%,5093,38733,11.12%,88.88%,14093,23326,71,147,4,120,
0500000US12041,"Gilchrist County, Florida",18245,8704,47.71%,52.29%,45,857,4.70%,865,379,69,5533,1379,1145,397,10884,1542,6398,1758,1214,35.07%,9.64%,7%,1348,16516,7.39%,92.61%,14827,788,62,56,2,45,
0500000US12043,"Glades County, Florida",13777,6186,44.90%,55.10%,43.9,992,7.20%,649,68,10,3788,361,849,365,7617,1214,4437,429,859,32.21%,3.11%,6%,3050,9076,22.14%,77.86%,7132,1434,193,34,0,45,
0500000US12045,"Gulf County, Florida",15073,6295,41.76%,58.24%,46.5,461,3.06%,345,334,15,3894,1029,1730,1031,10169,2761,4239,1363,1745,28.12%,9.04%,12%,555,13637,3.68%,96.32%,11222,1692,66,57,0,34,
0500000US12047,"Hamilton County, Florida",14397,6053,42.04%,57.96%,40.9,1183,8.22%,339,319,23,4917,514,632,236,7972,868,5256,833,655,36.51%,5.79%,5%,1455,12549,10.11%,89.89%,7633,4422,43,43,0,26,
0500000US12049,"Hardee County, Florida",27027,12651,46.81%,53.19%,47.1,2342,8.67%,1120,700,130,8422,842,1154,432,13245,1586,9542,1542,1284,35.31%,5.71%,5%,10604,14723,39.23%,60.77%,11873,2111,55,165,3,35,
0500000US12051,"Hendry County, Florida",41472,19450,46.90%,53.10%,44.1,4850,11.69%,1824,959,190,8945,2613,1475,715,18403,2190,10769,3572,1665,25.97%,8.61%,4%,22112,17507,53.32%,46.68%,12089,4195,155,339,4,120,
0500000US12053,"Hernando County, Florida",190700,98780,51.80%,48.20%,51.4,11936,6.26%,4757,5286,659,48282,14918,18035,9241,126303,27276,53039,20204,18694,27.81%,10.59%,10%,29045,165470,15.23%,84.77%,144060,9507,553,2566,86,868,
0500000US12055,"Highlands County, Florida",104574,53862,51.51%,48.49%,52.4,7795,7.45%,3021,2045,251,29874,7127,9244,4846,68583,14090,32895,9172,9495,31.46%,8.77%,9%,20943,80292,20.03%,79.97%,65511,9484,291,1602,49,307,
0500000US12057,"Hillsborough County, Florida",1451358,741543,51.09%,48.91%,44.7,90025,6.20%,38940,57021,16756,270314,93618,219537,124521,887397,344058,309254,150639,236293,21.31%,10.38%,16%,427381,1032381,29.45%,70.55%,667791,224479,2817,69928,914,9655,
0500000US12059,"Holmes County, Florida",19530,8942,45.79%,54.21%,44.8,1512,7.74%,590,450,41,6223,735,1047,353,11347,1400,6813,1185,1088,34.88%,6.07%,6%,688,18965,3.52%,96.48%,16766,1211,120,81,13,27,
0500000US12061,"Indian River County, Florida",156964,81625,52.00%,48.00%,52.4,7520,4.79%,3419,3397,1294,34964,11844,22461,14693,109362,37154,38383,15241,23755,24.45%,9.71%,15%,20832,138956,13.27%,86.73%,117422,13079,273,2341,52,730,
0500000US12063,"Jackson County, Florida",47409,21509,45.37%,54.63%,45.1,2194,4.63%,1225,1320,138,13369,2410,2607,1911,28693,4518,14594,3730,2745,30.78%,7.87%,6%,2215,45104,4.67%,95.33%,30629,12042,196,292,18,144,
0500000US12065,"Jefferson County, Florida",14278,6659,46.64%,53.36%,48.3,1037,7.26%,324,336,74,3788,719,1635,930,9080,2565,4112,1055,1709,28.80%,7.39%,12%,658,13852,4.61%,95.39%,8720,4600,36,34,3,54,
0500000US12067,"Lafayette County, Florida",8576,3388,39.51%,60.49%,35.3,492,5.74%,338,209,152,2545,278,272,291,4440,563,2883,487,424,33.62%,5.68%,5%,938,7288,10.94%,89.06%,6074,1024,16,10,1,18,
0500000US12069,"Lake County, Florida",356115,183669,51.58%,48.42%,53.7,16520,4.64%,8975,8547,1759,84761,28729,40345,24068,237685,64413,93736,37276,42104,26.32%,10.47%,12%,65375,318581,18.36%,81.64%,253214,37883,1016,8362,317,2916,
0500000US12071,"Lee County, Florida",756570,386064,51.03%,48.97%,50.9,38559,5.10%,17707,21066,3812,177980,52163,99647,63065,509868,162712,195687,73229,103459,25.87%,9.68%,14%,173161,587661,22.89%,77.11%,490476,55958,1228,12789,244,3974,
0500000US12073,"Leon County, Florida",291863,153611,52.63%,47.37%,36.9,30595,10.48%,11289,38354,8624,33321,16209,46364,35025,163114,81389,44610,54563,54988,15.28%,18.69%,19%,22914,269284,7.85%,92.15%,157458,87503,631,10465,155,1261,
0500000US12075,"Levy County, Florida",40979,21017,51.29%,48.71%,49.2,2874,7.01%,1485,826,14,12486,3738,2908,1339,25983,4247,13971,4564,2922,34.09%,11.14%,7%,4080,38835,9.96%,90.04%,32874,3597,122,292,11,170,
0500000US12077,"Liberty County, Florida",8333,3394,40.73%,59.27%,37.4,410,4.92%,184,328,32,2705,298,505,311,4781,816,2889,626,537,34.67%,7.51%,6%,562,7412,6.74%,93.26%,5729,1353,52,18,1,26,
0500000US12079,"Madison County, Florida",18557,8583,46.25%,53.75%,39.7,1903,10.25%,644,400,41,5083,1404,1248,652,10976,1900,5727,1804,1289,30.86%,9.72%,7%,881,17087,4.75%,95.25%,10132,6281,53,45,0,63,
0500000US12081,"Manatee County, Florida",393847,203685,51.72%,48.28%,51.1,17564,4.46%,9424,9310,2079,88447,27243,54669,34705,264641,89374,97871,36553,56748,24.85%,9.28%,14%,70979,328731,18.02%,81.98%,273101,31147,779,8433,246,1583,
0500000US12083,"Marion County, Florida",360210,187347,52.01%,47.99%,49.8,24617,6.83%,11036,7350,909,98061,25255,36242,19338,236527,55580,109097,32605,37151,30.29%,9.05%,10%,55910,319998,15.52%,84.48%,253837,42795,986,5973,148,1747,
0500000US12085,"Martin County, Florida",160420,81297,50.68%,49.32%,50.3,6876,4.29%,3772,3894,728,31807,11556,26373,15282,113727,41655,35579,15450,27101,22.18%,9.63%,17%,24187,134244,15.08%,84.92%,119216,7277,218,2246,42,525,
0500000US12086,"Miami-Dade County, Florida",2705528,1390068,51.38%,48.62%,42,165847,6.13%,65173,106347,23875,515319,184402,371822,218483,1576177,590305,580492,290749,395697,21.46%,10.75%,15%,1856938,844829,68.63%,31.37%,361517,378756,1589,41672,385,14667,
0500000US12087,"Monroe County, Florida",75137,35868,47.74%,52.26%,52.2,3278,4.36%,1432,2128,388,16262,4972,12996,7800,54184,20796,17694,7100,13384,23.55%,9.45%,18%,19432,63442,25.86%,74.14%,54731,4517,169,1137,61,407,
0500000US12089,"Nassau County, Florida",85762,43210,50.38%,49.62%,57.5,4265,4.97%,2232,1720,672,20253,5443,12160,7202,57906,19362,22485,7163,12832,26.22%,8.35%,15%,4449,85903,5.19%,94.81%,75817,4945,222,863,52,293,
0500000US12091,"Okaloosa County, Florida",207430,102051,49.20%,50.80%,51.5,8831,4.26%,6412,7428,2264,35786,15728,28365,17513,131979,45878,42198,23156,30629,20.34%,11.16%,15%,22578,189090,10.88%,89.12%,146271,18896,799,6578,448,1206,
0500000US12093,"Okeechobee County, Florida",41611,19194,46.13%,53.87%,46.5,2166,5.21%,1394,832,243,11428,2199,3036,1186,23514,4222,12822,3031,3279,30.81%,7.28%,8%,9857,29787,23.69%,76.31%,24671,3318,263,332,14,146,
0500000US12095,"Orange County, Florida",1373784,700328,50.98%,49.02%,43.4,80779,5.88%,36564,73271,18007,223340,104225,213584,114384,821198,327968,259904,177496,231591,18.92%,12.92%,17%,473025,956883,34.43%,65.57%,531362,263624,2207,76870,1114,16015,
0500000US12097,"Osceola County, Florida",363666,184334,50.69%,49.31%,43.8,22153,6.09%,11239,15832,2762,70710,26804,38357,17495,207380,55852,81949,42636,41119,22.53%,11.72%,11%,211089,177567,58.04%,41.96%,113362,35145,562,11370,240,4218,
0500000US12099,"Palm Beach County, Florida",1482057,763563,51.52%,48.48%,46.4,77540,5.23%,31244,49731,12283,260603,99339,247525,156294,965949,403819,291847,149070,259808,19.69%,10.06%,18%,349933,1142258,23.61%,76.39%,779759,255724,1536,43356,494,10766,
0500000US12101,"Pasco County, Florida",539885,277429,51.39%,48.61%,50.4,28012,5.19%,13376,16442,2883,133450,39785,64038,32627,352776,96665,146826,56227,66921,27.20%,10.41%,12%,93157,468734,17.25%,82.75%,392375,31601,1388,16408,308,2771,
0500000US12103,"Pinellas County, Florida",970985,505000,52.01%,47.99%,44.6,52156,5.37%,21586,25916,7696,204218,76718,157659,86071,687314,243730,225804,102634,165355,23.26%,10.57%,17%,102439,856668,10.55%,89.45%,684463,91431,1942,33700,797,4835,
0500000US12105,"Polk County, Florida",705735,359923,51.00%,49.00%,46.1,45183,6.40%,24490,20991,3825,165471,46877,66256,34709,418991,100965,189961,67868,70081,26.92%,9.62%,10%,187695,537351,26.60%,73.40%,392621,100950,1623,13181,300,3684,
0500000US12107,"Putnam County, Florida",73784,37496,50.82%,49.18%,44.9,6649,9.01%,2580,1366,218,22309,4309,4765,2394,43620,7159,24889,5675,4983,33.73%,7.69%,7%,7816,65505,10.59%,89.41%,50541,11274,280,469,37,248,
0500000US12109,"St. Johns County, Florida",255410,131184,51.36%,48.64%,56.8,9089,3.56%,6267,8004,1649,39727,16984,50008,30777,172149,80785,45994,24988,51657,18.01%,9.78%,20%,22607,250818,8.85%,91.15%,214428,12940,544,9764,151,1225,
0500000US12111,"St. Lucie County, Florida",320914,164089,51.13%,48.87%,49.5,15944,4.97%,9369,8731,1892,75324,24315,34915,17682,204257,52597,84693,33046,36807,26.39%,10.30%,11%,66320,262906,20.67%,79.33%,176533,64597,568,5678,141,2470,
0500000US12113,"Santa Rosa County, Florida",179587,87931,48.96%,51.04%,54.9,7460,4.15%,5442,4486,1788,34228,17118,22052,12309,115322,34361,39670,21604,23840,22.09%,12.03%,13%,11890,176110,6.62%,93.38%,147518,10690,1112,3818,362,847,
0500000US12115,"Sarasota County, Florida",427766,223798,52.32%,47.68%,54.4,16681,3.90%,8850,9297,2271,94901,31010,71035,53704,319462,124739,103751,40307,73306,24.25%,9.42%,17%,43236,390770,10.11%,89.89%,349700,16165,695,8407,168,1902,
0500000US12117,"Seminole County, Florida",466695,241042,51.65%,48.35%,49.9,23612,5.06%,9566,19721,4880,67674,42589,89469,46134,312076,135603,77240,62310,94349,16.55%,13.35%,20%,106539,364317,22.83%,77.17%,264072,50276,765,25164,243,2975,
0500000US12119,"Sumter County, Florida",129938,65220,50.19%,49.81%,62.2,4829,3.72%,1422,1114,145,35584,10706,21088,16301,107640,37389,37006,11820,21233,28.48%,9.10%,16%,7583,122169,5.84%,94.16%,109213,8313,311,1238,31,320,
0500000US12121,"Suwannee County, Florida",44290,21202,47.87%,52.13%,46.8,1935,4.37%,1346,993,268,13082,1919,2824,2175,26215,4999,14428,2912,3092,32.58%,6.57%,7%,4785,38689,10.80%,89.20%,31664,4920,167,270,16,143,
0500000US12123,"Taylor County, Florida",21709,9582,44.14%,55.86%,47,1016,4.68%,419,478,49,7445,1072,1073,648,12951,1721,7864,1550,1122,36.22%,7.14%,5%,866,20930,3.99%,96.01%,15629,4196,102,224,0,45,
0500000US12125,"Union County, Florida",15282,5113,33.46%,66.54%,39.2,550,3.60%,476,219,72,4223,1039,785,410,8650,1195,4699,1258,857,30.75%,8.23%,6%,764,15383,5.00%,95.00%,11585,3197,42,35,0,62,
0500000US12127,"Volusia County, Florida",546107,280025,51.28%,48.72%,47.1,32626,5.97%,13108,20719,3456,127856,48378,65384,33742,368220,99126,140964,69097,68840,25.81%,12.65%,13%,82652,470891,15.13%,84.87%,379527,55338,1262,10478,266,2692,
0500000US12129,"Wakulla County, Florida",32855,14884,45.30%,54.70%,52.1,1004,3.06%,720,750,118,8353,2044,2760,1689,21001,4449,9073,2794,2878,27.62%,8.50%,9%,1577,32187,4.80%,95.20%,25987,4202,154,198,19,126,
0500000US12131,"Walton County, Florida",71049,35198,49.54%,50.46%,55.3,3525,4.96%,1375,1775,452,15088,4986,10380,5313,46664,15693,16463,6761,10832,23.17%,9.52%,15%,6187,69118,8.71%,91.29%,60644,3294,415,907,38,307,
0500000US12133,"Washington County, Florida",25094,11536,45.97%,54.03%,42.1,2406,9.59%,733,562,25,7780,1057,1451,750,14980,2201,8513,1619,1476,33.92%,6.45%,6%,924,24394,3.68%,96.32%,19484,3236,222,132,28,87,
0500000US13001,"Appling County, Georgia",18428,9063,49.18%,50.82%,54.4,1912,10.38%,740,398,23,4628,1082,589,584,9530,1173,5368,1480,612,29.13%,8.03%,3%,1825,16619,9.90%,90.10%,12674,3339,33,123,1,32,
0500000US13003,"Atkinson County, Georgia",8311,4170,50.17%,49.83%,50.9,707,8.51%,316,203,25,1805,350,300,346,3574,646,2121,553,325,25.52%,6.65%,4%,2048,6238,24.64%,75.36%,4801,1208,30,12,4,16,
0500000US13005,"Bacon County, Georgia",11140,5666,50.86%,49.14%,43.3,971,8.72%,367,350,14,3280,421,322,359,6041,681,3647,771,336,32.74%,6.92%,3%,875,10265,7.85%,92.15%,8103,1747,4,40,4,32,
0500000US13007,"Baker County, Georgia",3090,1542,49.90%,50.10%,45.2,301,9.74%,177,28,22,812,189,244,246,1907,490,989,217,266,32.01%,7.02%,9%,143,2733,4.63%,95.37%,1514,1128,1,18,0,2,
0500000US13009,"Baldwin County, Georgia",45072,22400,49.70%,50.30%,37.8,5537,12.28%,2020,5052,341,9166,2657,4210,2637,24329,6847,11186,7709,4551,24.82%,17.10%,10%,1139,42660,2.53%,97.47%,22432,18318,64,599,27,193,
0500000US13011,"Banks County, Georgia",18900,9397,49.72%,50.28%,60.4,1236,6.54%,452,539,27,4415,1058,1305,766,9872,2071,4867,1597,1332,25.75%,8.45%,7%,1164,16871,6.16%,93.84%,15578,394,54,189,8,28,
0500000US13013,"Barrow County, Georgia",81294,41434,50.97%,49.03%,54.6,4171,5.13%,2583,2489,296,18357,4418,6672,4157,46400,10829,20940,6907,6968,25.76%,8.50%,9%,10560,72945,12.99%,87.01%,55582,10141,130,3233,17,459,
0500000US13015,"Bartow County, Georgia",106456,53789,50.53%,49.47%,53,6077,5.71%,4504,2655,528,25475,5396,9630,4448,61357,14078,29979,8051,10158,28.16%,7.56%,10%,10751,98150,10.10%,89.90%,80159,11309,254,1169,40,466,
0500000US13017,"Ben Hill County, Georgia",16889,8671,51.34%,48.66%,38.6,2418,14.32%,556,516,93,5235,1058,864,381,9483,1245,5791,1574,957,34.29%,9.32%,6%,1054,16140,6.24%,93.76%,9219,6222,57,116,0,48,
0500000US13019,"Berrien County, Georgia",19206,9810,51.08%,48.92%,51.4,1955,10.18%,588,477,26,5387,990,1261,487,10553,1748,5975,1467,1287,31.11%,7.64%,7%,1045,17115,5.44%,94.56%,14396,1934,22,80,10,62,
0500000US13021,"Bibb County, Georgia",153026,81148,53.03%,46.97%,37.4,16884,11.03%,4344,7819,1203,31018,7336,13551,11787,86461,25338,35362,15155,14754,23.11%,9.90%,10%,6737,150609,4.40%,95.60%,56787,85234,281,3209,42,602,
0500000US13023,"Bleckley County, Georgia",12870,6795,52.80%,47.20%,44.1,971,7.54%,879,914,32,3171,764,820,659,7380,1479,4050,1678,852,31.47%,13.04%,7%,469,12114,3.64%,96.36%,8867,2788,11,153,8,30,
0500000US13025,"Brantley County, Georgia",18924,9488,50.14%,49.86%,47,1666,8.80%,602,293,20,5916,1190,435,454,10440,889,6518,1483,455,34.44%,7.84%,2%,326,17695,1.72%,98.28%,16317,562,45,42,3,34,
0500000US13027,"Brooks County, Georgia",15548,8035,51.68%,48.32%,50.2,2287,14.71%,511,273,0,3731,1218,1318,503,9263,1821,4242,1491,1318,27.28%,9.59%,8%,955,15346,6.14%,93.86%,9066,5684,24,67,6,42,
0500000US13029,"Bryan County, Georgia",38321,19346,50.48%,49.52%,56.9,1848,4.82%,1028,896,345,6269,2214,5061,2905,22418,7966,7297,3110,5406,19.04%,8.12%,14%,3269,41469,8.53%,91.47%,31321,6330,102,1032,53,184,
0500000US13031,"Bulloch County, Georgia",77719,39778,51.18%,48.82%,38.8,7873,10.13%,3560,12995,981,12528,3793,6865,5227,38610,12092,16088,16788,7846,20.70%,21.60%,10%,4180,76919,5.38%,94.62%,49712,22775,159,1283,62,249,
0500000US13033,"Burke County, Georgia",22567,12002,53.18%,46.82%,50,1911,8.47%,953,728,134,5295,1542,1459,644,11825,2103,6248,2270,1593,27.69%,10.06%,7%,777,23819,3.44%,96.56%,11941,10957,45,97,10,66,
0500000US13035,"Butts County, Georgia",24463,11505,47.03%,52.97%,47.7,1720,7.03%,1091,619,0,7145,1238,1352,565,13853,1917,8236,1857,1352,33.67%,7.59%,6%,803,24631,3.28%,96.72%,16628,6808,39,102,9,164,
0500000US13037,"Calhoun County, Georgia",6301,2478,39.33%,60.67%,28.5,482,7.65%,268,68,0,1732,196,394,161,3539,555,2000,264,394,31.74%,4.19%,6%,149,5424,2.36%,97.64%,1766,3569,8,19,0,1,
0500000US13039,"Camden County, Georgia",53960,26378,48.88%,51.12%,51.9,3924,7.27%,3189,2036,382,11045,2993,4960,2820,31738,7780,14234,5029,5342,26.38%,9.32%,10%,3658,51110,6.78%,93.22%,37203,9497,185,845,66,325,
0500000US13043,"Candler County, Georgia",10834,5427,50.09%,49.91%,44.6,1414,13.05%,305,370,45,2924,416,589,225,5624,814,3229,786,634,29.80%,7.25%,6%,1378,9603,12.72%,87.28%,6567,2681,19,63,3,26,
0500000US13045,"Carroll County, Georgia",118692,60967,51.37%,48.63%,47.7,7050,5.94%,5467,7270,651,25143,4935,10884,5740,64032,16624,30610,12205,11535,25.79%,10.28%,10%,9586,109562,8.08%,91.92%,80725,21781,271,1104,21,505,
0500000US13047,"Catoosa County, Georgia",67181,34834,51.85%,48.15%,55,2669,3.97%,1944,1959,360,15177,3941,7292,3459,41467,10751,17121,5900,7652,25.48%,8.78%,11%,2341,65531,3.48%,96.52%,59280,1808,181,1025,84,133,
0500000US13049,"Charlton County, Georgia",13032,5418,41.58%,58.43%,42.5,1593,12.22%,442,408,31,3911,632,654,540,7476,1194,4353,1040,685,33.40%,7.98%,5%,2036,10482,15.62%,84.38%,7532,2386,40,109,2,30,
0500000US13051,"Chatham County, Georgia",289649,150325,51.90%,48.10%,40.8,20979,7.24%,9120,14263,4252,47320,15214,40792,26684,176913,67476,56440,29477,45044,19.49%,10.18%,16%,23790,271501,8.21%,91.79%,139433,108011,619,10620,408,1447,
0500000US13053,"Chattahoochee County, Georgia",10470,3691,35.25%,64.75%,36.8,831,7.94%,1891,1031,342,1506,361,880,436,4592,1316,3397,1392,1222,32.45%,13.30%,12%,1610,7955,15.38%,84.62%,5403,1463,35,304,104,55,
0500000US13055,"Chattooga County, Georgia",24826,12013,48.39%,51.61%,45.5,1521,6.13%,686,641,41,6570,1093,1039,626,12386,1665,7256,1734,1080,29.23%,6.98%,4%,1297,23668,5.22%,94.78%,20079,2391,45,102,0,81,
0500000US13057,"Cherokee County, Georgia",253780,128851,50.77%,49.23%,58.5,9182,3.62%,6550,8135,2235,40184,14154,44657,18754,158169,63411,46734,22289,46892,18.42%,8.78%,18%,32111,234509,12.65%,87.35%,197867,17326,502,5429,100,1544,
0500000US13059,"Clarke County, Georgia",126952,66545,52.42%,47.58%,31.2,19111,15.05%,5836,21618,4507,14315,4754,16126,16554,64462,32680,20151,26372,20633,15.87%,20.77%,16%,14336,114335,11.29%,88.71%,72201,31367,297,4920,66,980,
0500000US13061,"Clay County, Georgia",2931,1491,50.87%,49.13%,38.7,326,11.12%,15,87,19,738,284,195,170,1792,365,753,371,214,25.69%,12.66%,7%,41,2807,1.40%,98.60%,1143,1593,1,6,0,7,
0500000US13063,"Clayton County, Georgia",287560,153306,53.31%,46.69%,33.7,20888,7.26%,11770,9562,1746,59885,16454,22589,11692,152056,34281,71655,26016,24335,24.92%,9.05%,8%,42546,255049,14.80%,85.20%,25902,205301,601,13491,119,1800,
0500000US13065,"Clinch County, Georgia",6648,3313,49.84%,50.17%,47.9,1514,22.77%,143,142,30,1622,177,321,165,3238,486,1765,319,351,26.55%,4.80%,5%,253,6496,3.81%,96.19%,4256,1950,30,22,7,31,
0500000US13067,"Cobb County, Georgia",756653,390224,51.57%,48.43%,50.1,30494,4.03%,17191,32579,10098,93871,35924,157496,89886,472793,247382,111062,68503,167594,14.68%,9.05%,22%,111240,654909,14.70%,85.30%,369182,200072,1289,42533,293,7382,
0500000US13069,"Coffee County, Georgia",43070,21042,48.86%,51.15%,45.2,3765,8.74%,1533,1672,118,10681,1770,2159,1296,21253,3455,12214,3442,2277,28.36%,7.99%,5%,5430,37662,12.61%,87.39%,24158,11872,62,299,14,69,
0500000US13071,"Colquitt County, Georgia",45510,22909,50.34%,49.66%,42.5,5308,11.66%,1196,1643,355,11408,1898,2230,1842,22218,4072,12604,3541,2585,27.70%,7.78%,6%,8709,37189,19.14%,80.86%,25588,9995,83,388,15,106,
0500000US13073,"Columbia County, Georgia",154257,78768,51.06%,48.94%,54.1,4911,3.18%,4173,5076,1146,24999,12036,22476,15028,95565,37504,29172,17112,23622,18.91%,11.09%,15%,11858,144152,7.69%,92.31%,99111,27621,354,7102,271,897,
0500000US13075,"Cook County, Georgia",17217,8900,51.69%,48.31%,51.1,1834,10.65%,702,490,64,3706,1097,1070,702,9114,1772,4408,1587,1134,25.60%,9.22%,7%,1134,16095,6.59%,93.41%,10658,4753,29,100,4,51,
0500000US13077,"Coweta County, Georgia",145839,74902,51.36%,48.64%,56.1,5996,4.11%,4024,4949,1018,26858,8289,22048,10660,88953,32708,30882,13238,23066,21.18%,9.08%,16%,11053,135105,7.58%,92.42%,99421,25544,298,3329,62,669,
0500000US13079,"Crawford County, Georgia",12267,5667,46.20%,53.80%,52.2,1073,8.75%,426,429,0,3589,524,456,469,7228,925,4015,953,456,32.73%,7.77%,4%,415,11715,3.38%,96.62%,8866,2267,45,31,3,44,
0500000US13081,"Crisp County, Georgia",22509,11647,51.74%,48.26%,39,2303,10.23%,805,911,118,5994,1317,1152,903,12445,2055,6799,2228,1270,30.21%,9.90%,6%,634,19494,2.82%,97.18%,9892,8821,18,180,4,64,
0500000US13083,"Dade County, Georgia",16183,8233,50.87%,49.13%,54.2,593,3.66%,712,1042,18,4088,1016,1260,498,9092,1758,4800,2058,1278,29.66%,12.72%,8%,364,15887,2.25%,97.75%,14786,141,68,129,5,31,
0500000US13085,"Dawson County, Georgia",25277,12501,49.46%,50.54%,57.7,1647,6.52%,1122,631,170,4739,1150,3944,2108,15889,6052,5861,1781,4114,23.19%,7.05%,16%,1605,25193,6.35%,93.65%,23544,200,63,235,14,94,
0500000US13087,"Decatur County, Georgia",26595,13804,51.90%,48.10%,44.3,3074,11.56%,1518,498,79,6476,1976,1466,1023,14692,2489,7994,2474,1545,30.06%,9.30%,6%,1911,27456,7.19%,92.81%,14280,12200,64,183,16,64,
0500000US13089,"DeKalb County, Georgia",755287,398536,52.77%,47.23%,38.3,45805,6.06%,19185,24989,10510,106451,37368,133535,101657,465786,235192,125636,62357,144045,16.63%,8.26%,19%,81471,682911,10.79%,89.21%,215895,384438,1161,50076,202,4719,
0500000US13091,"Dodge County, Georgia",20725,9902,47.78%,52.22%,46.6,1532,7.39%,698,719,66,6224,1044,1552,751,12909,2303,6922,1763,1618,33.40%,8.51%,8%,620,19305,2.99%,97.01%,12865,5847,21,95,8,42,
0500000US13093,"Dooly County, Georgia",13571,6176,45.51%,54.49%,41.9,794,5.85%,614,380,11,4165,678,827,456,7975,1283,4779,1058,838,35.21%,7.80%,6%,797,10411,5.87%,94.13%,4611,5540,17,51,2,14,
0500000US13095,"Dougherty County, Georgia",88696,47803,53.90%,46.11%,31.8,11181,12.61%,3260,4788,501,16744,5160,7173,5481,48198,12654,20004,9948,7674,22.55%,11.22%,9%,2413,83377,2.72%,97.28%,20631,59720,128,647,20,234,
0500000US13097,"Douglas County, Georgia",145063,76031,52.41%,47.59%,46.4,8270,5.70%,4909,5376,1180,28064,8268,16724,9721,82415,26445,32973,13644,17904,22.73%,9.41%,12%,16035,128202,11.05%,88.95%,49877,68763,335,2313,97,1072,
0500000US13099,"Early County, Georgia",10218,5567,54.48%,45.52%,39.7,1323,12.95%,437,340,0,2590,516,642,282,5453,924,3027,856,642,29.62%,8.38%,6%,186,10668,1.82%,98.18%,4813,5534,31,47,0,11,
0500000US13101,"Echols County, Georgia",3944,2169,55.00%,45.01%,58,506,12.83%,228,31,15,1262,177,150,60,2062,210,1490,208,165,37.78%,5.27%,4%,1091,2606,27.66%,72.34%,2328,147,37,8,0,2,
0500000US13103,"Effingham County, Georgia",62241,31404,50.46%,49.55%,55.1,1642,2.64%,2679,1580,193,15336,3093,6898,2818,36309,9716,18015,4673,7091,28.94%,7.51%,11%,3492,61277,5.61%,94.39%,48204,8747,181,677,28,269,
0500000US13105,"Elbert County, Georgia",19164,9994,52.15%,47.85%,49.6,1961,10.23%,497,602,38,5548,772,1039,550,10636,1589,6045,1374,1077,31.54%,7.17%,6%,996,18641,5.20%,94.80%,12610,5253,26,182,3,53,
0500000US13107,"Emanuel County, Georgia",22525,11382,50.53%,49.47%,40,2363,10.49%,917,542,69,6400,1220,909,788,11807,1697,7317,1762,978,32.48%,7.82%,4%,993,21775,4.41%,95.59%,13815,7246,33,141,2,40,
0500000US13109,"Evans County, Georgia",10671,5318,49.84%,50.16%,43,1155,10.82%,283,301,14,2766,381,626,523,5487,1149,3049,682,640,28.57%,6.39%,6%,1237,9537,11.59%,88.41%,6038,3083,15,78,11,21,
0500000US13111,"Fannin County, Georgia",25797,13231,51.29%,48.71%,59,1247,4.83%,612,644,62,6836,2013,2551,1864,17592,4415,7448,2657,2613,28.87%,10.30%,10%,753,24566,2.92%,97.08%,23351,85,85,113,3,55,
0500000US13113,"Fayette County, Georgia",113544,58580,51.59%,48.41%,58.7,2186,1.93%,3174,4208,1057,16424,6374,21905,14382,74124,36287,19598,10582,22962,17.26%,9.32%,20%,9480,109714,8.35%,91.65%,68144,29166,212,6362,44,848,
0500000US13115,"Floyd County, Georgia",97805,50574,51.71%,48.29%,48.6,6334,6.48%,3194,4433,532,21804,5338,7906,6057,54668,13963,24998,9771,8438,25.56%,9.99%,9%,11466,87118,11.72%,88.28%,67747,13940,191,1287,24,371,
0500000US13117,"Forsyth County, Georgia",236605,119153,50.36%,49.64%,64.8,6522,2.76%,6131,6660,2516,23565,10405,54664,29799,143803,84463,29696,17065,57180,12.55%,7.21%,24%,25226,226057,10.66%,89.34%,159407,10455,456,45117,85,1255,
0500000US13119,"Franklin County, Georgia",23015,11724,50.94%,49.06%,51,1824,7.93%,884,909,383,5630,1530,1544,1131,12733,2675,6514,2439,1927,28.30%,10.60%,8%,1121,22303,4.87%,95.13%,19262,1888,34,261,3,79,
0500000US13121,"Fulton County, Georgia",1051550,542562,51.60%,48.40%,38.8,63308,6.02%,25650,46488,21841,123904,43295,229596,160697,666413,390293,149554,89783,251437,14.22%,8.54%,24%,86302,980408,8.21%,91.79%,404793,448803,1558,80632,381,6444,
0500000US13123,"Gilmer County, Georgia",30986,15512,50.06%,49.94%,55.6,1527,4.93%,977,580,34,8149,1796,2950,1971,19379,4921,9126,2376,2984,29.45%,7.67%,10%,3599,27754,11.61%,88.39%,26365,127,62,131,0,82,
0500000US13125,"Glascock County, Georgia",2984,1543,51.71%,48.29%,47.5,85,2.85%,161,67,28,769,123,185,26,1553,211,930,190,213,31.17%,6.37%,7%,52,2832,1.74%,98.26%,2573,196,0,7,2,0,
0500000US13127,"Glynn County, Georgia",85008,44968,52.90%,47.10%,48.3,6304,7.42%,2622,2140,484,16072,5084,10904,6830,52954,17734,18694,7224,11388,21.99%,8.50%,13%,6336,78163,7.45%,92.55%,52987,20469,175,1175,92,352,
0500000US13129,"Gordon County, Georgia",57756,29436,50.97%,49.03%,52.3,3634,6.29%,1762,1922,254,13419,2569,3358,2795,30165,6153,15181,4491,3612,26.28%,7.78%,6%,8957,48587,15.51%,84.49%,43317,2075,122,719,15,123,
0500000US13131,"Grady County, Georgia",24693,12601,51.03%,48.97%,50.2,1907,7.72%,553,972,70,6485,1463,1509,1064,13686,2573,7038,2435,1579,28.50%,9.86%,6%,3273,22963,13.25%,86.75%,14715,7285,89,110,6,86,
0500000US13133,"Greene County, Georgia",17808,9008,50.58%,49.42%,53.4,989,5.55%,593,270,143,4084,864,2481,1566,11524,4047,4677,1134,2624,26.26%,6.37%,15%,1289,17626,7.24%,92.76%,11126,5783,28,174,2,58,
0500000US13135,"Gwinnett County, Georgia",926414,474366,51.21%,48.80%,52.1,39829,4.30%,27851,33340,9816,133629,56007,143945,77423,520594,221368,161480,89347,153761,17.43%,9.64%,17%,220460,736602,23.80%,76.20%,310583,257124,1532,126526,387,6489,
0500000US13137,"Habersham County, Georgia",45204,23906,52.89%,47.12%,51.6,2282,5.05%,1525,1947,169,10438,1841,3476,2930,24375,6406,11963,3788,3645,26.46%,8.38%,8%,6880,39151,15.22%,84.78%,34694,1722,83,990,35,109,
0500000US13139,"Hall County, Georgia",201434,101265,50.27%,49.73%,52.6,10571,5.25%,6927,7170,1192,37078,8898,19459,12237,104653,31696,44005,16068,20651,21.85%,7.98%,10%,57010,146126,28.30%,71.70%,120418,14256,341,4198,85,708,
0500000US13141,"Hancock County, Georgia",8500,3586,42.19%,57.81%,34.4,445,5.24%,321,79,0,2568,455,470,169,4811,639,2889,534,470,33.99%,6.28%,6%,63,8672,0.74%,99.26%,2413,6025,23,37,1,10,
0500000US13143,"Haralson County, Georgia",29608,15057,50.85%,49.15%,57.2,1408,4.76%,1056,697,98,7422,1191,2188,1326,16749,3514,8478,1888,2286,28.63%,6.38%,8%,497,29422,1.68%,98.32%,26825,1253,56,186,9,87,
0500000US13145,"Harris County, Georgia",34676,17403,50.19%,49.81%,62.2,1109,3.20%,1262,1133,133,6322,2560,4560,3361,22883,7921,7584,3693,4693,21.87%,10.65%,14%,1417,33251,4.09%,95.91%,25925,5170,101,388,21,138,
0500000US13147,"Hart County, Georgia",25981,13115,50.48%,49.52%,51.2,1292,4.97%,622,536,60,6763,1628,2330,939,15736,3269,7385,2164,2390,28.42%,8.33%,9%,931,24897,3.58%,96.42%,19250,4324,36,335,2,86,
0500000US13149,"Heard County, Georgia",11785,5969,50.65%,49.35%,50.8,531,4.51%,395,344,63,3385,463,329,412,6617,741,3780,807,392,32.07%,6.85%,3%,253,11159,2.15%,97.85%,9589,930,33,53,4,29,
0500000US13151,"Henry County, Georgia",229994,120396,52.35%,47.65%,50.2,7309,3.18%,7075,9402,1713,46689,14412,26196,15655,136898,41851,53764,23814,27909,23.38%,10.35%,12%,18437,222275,8.02%,91.98%,86297,116431,427,7976,119,1650,
0500000US13153,"Houston County, Georgia",155317,80428,51.78%,48.22%,51.4,8269,5.32%,4547,6594,1252,27342,10929,18087,13491,94331,31578,31889,17523,19339,20.53%,11.28%,12%,11807,151826,7.60%,92.40%,86211,51992,339,4905,124,703,
0500000US13155,"Irwin County, Georgia",9379,4324,46.10%,53.90%,46.5,968,10.32%,502,235,9,2364,517,567,542,5248,1109,2866,752,576,30.56%,8.02%,6%,663,9003,7.07%,92.93%,6402,2224,15,119,1,24,
0500000US13157,"Jackson County, Georgia",70467,35555,50.46%,49.54%,58.5,2976,4.22%,2332,1525,184,15289,4173,7644,3534,40657,11178,17621,5698,7828,25.01%,8.09%,11%,6712,69195,9.53%,90.47%,59064,5136,127,1744,30,294,
0500000US13159,"Jasper County, Georgia",14074,7202,51.17%,48.83%,56.6,1147,8.15%,398,215,91,4119,790,926,500,8318,1426,4517,1005,1017,32.09%,7.14%,7%,684,13904,4.86%,95.14%,10771,2442,34,22,1,62,
0500000US13161,"Jeff Davis County, Georgia",15063,7732,51.33%,48.67%,49.3,1819,12.08%,483,393,31,3587,796,633,429,7584,1062,4070,1189,664,27.02%,7.89%,4%,2047,12732,13.59%,86.41%,9950,2293,26,50,7,33,
0500000US13163,"Jefferson County, Georgia",15489,8026,51.82%,48.18%,41.7,1664,10.74%,526,226,43,4276,799,900,231,8318,1131,4802,1025,943,31.00%,6.62%,6%,462,15247,2.98%,97.02%,6834,7970,21,70,0,25,
0500000US13165,"Jenkins County, Georgia",8787,4567,51.98%,48.03%,47,1435,16.33%,345,259,16,2839,433,207,108,4715,315,3184,692,223,36.24%,7.88%,3%,303,8371,3.45%,96.55%,4611,3536,29,12,5,30,
0500000US13167,"Johnson County, Georgia",9717,4228,43.51%,56.49%,37.7,801,8.24%,371,157,7,3398,497,292,202,5221,494,3769,654,299,38.79%,6.73%,3%,117,9072,1.20%,98.80%,5800,3017,23,28,15,14,
0500000US13169,"Jones County, Georgia",28622,14859,51.92%,48.09%,59.8,1537,5.37%,1049,699,142,7631,2121,2459,1662,18141,4121,8680,2820,2601,30.33%,9.85%,9%,476,27871,1.66%,98.34%,20074,6739,46,138,7,73,
0500000US13171,"Lamar County, Georgia",18834,9540,50.65%,49.35%,45.4,1290,6.85%,689,1392,18,4953,899,1013,721,10767,1734,5642,2291,1031,29.96%,12.16%,5%,475,18025,2.52%,97.48%,12344,4888,13,102,4,48,
0500000US13173,"Lanier County, Georgia",10534,5620,53.35%,46.65%,48.6,1006,9.55%,673,355,23,2661,665,960,435,6013,1395,3334,1020,983,31.65%,9.68%,9%,572,9305,5.43%,94.57%,6595,2138,31,81,14,33,
0500000US13175,"Laurens County, Georgia",47404,25017,52.77%,47.23%,42.2,6439,13.58%,1661,1356,79,13168,2682,2815,2636,27462,5451,14829,4038,2894,31.28%,8.52%,6%,1424,48146,3.00%,97.00%,27881,18219,80,507,14,141,
0500000US13177,"Lee County, Georgia",29735,14807,49.80%,50.20%,58.6,1317,4.43%,702,873,121,5730,2335,3020,2276,18004,5296,6432,3208,3141,21.63%,10.79%,11%,953,32210,3.20%,96.80%,22758,7331,57,850,9,98,
0500000US13179,"Liberty County, Georgia",62039,30723,49.52%,50.48%,52.5,4280,6.90%,4351,2954,515,10662,4266,4767,2187,33116,6954,15013,7220,5282,24.20%,11.64%,9%,7786,57470,12.55%,87.45%,24004,27309,225,1325,437,322,
0500000US13181,"Lincoln County, Georgia",7929,4128,52.06%,47.94%,44.5,766,9.66%,269,158,88,2549,461,568,244,4941,812,2818,619,656,35.54%,7.81%,8%,92,7598,1.16%,98.84%,5196,2116,18,20,3,10,
0500000US13183,"Long County, Georgia",19236,9545,49.62%,50.38%,41.5,2072,10.77%,895,253,8,4994,817,1020,762,10451,1782,5889,1070,1028,30.61%,5.56%,5%,1979,14189,10.29%,89.71%,8774,4028,62,164,88,91,
0500000US13185,"Lowndes County, Georgia",116436,59926,51.47%,48.53%,41.6,16195,13.91%,6080,9858,1381,22496,6027,10927,7123,60796,18050,28576,15885,12308,24.54%,13.64%,11%,7872,110379,6.76%,93.24%,59306,43946,312,1908,100,450,
0500000US13187,"Lumpkin County, Georgia",33009,17012,51.54%,48.46%,48.7,2091,6.33%,2183,3488,316,5878,1292,3874,2684,17953,6558,8061,4780,4190,24.42%,14.48%,13%,1790,31698,5.42%,94.58%,29241,412,151,257,21,118,
0500000US13189,"McDuffie County, Georgia",21404,11521,53.83%,46.17%,47.7,1557,7.27%,925,455,37,5827,1182,1255,908,12159,2163,6752,1637,1292,31.55%,7.65%,6%,790,20842,3.69%,96.31%,11417,8644,45,76,13,37,
0500000US13191,"McIntosh County, Georgia",14217,7089,49.86%,50.14%,54.8,601,4.23%,258,263,16,4327,763,1274,682,9696,1956,4585,1026,1290,32.25%,7.22%,9%,231,10744,1.62%,98.38%,7060,3176,32,43,0,35,
0500000US13193,"Macon County, Georgia",13107,6160,47.00%,53.00%,35.4,1316,10.04%,534,321,8,3051,538,582,368,6799,950,3585,859,590,27.35%,6.55%,5%,472,11610,3.60%,96.40%,4078,7150,15,156,7,20,
0500000US13195,"Madison County, Georgia",29624,15168,51.20%,48.80%,53,2246,7.58%,1011,697,170,7302,1950,2074,1852,17015,3926,8313,2647,2244,28.06%,8.94%,8%,1956,28164,6.60%,93.40%,23549,2753,44,521,4,106,
0500000US13197,"Marion County, Georgia",8450,4428,52.40%,47.60%,55,634,7.50%,212,194,38,2227,434,588,213,4765,801,2439,628,626,28.86%,7.43%,7%,560,6938,6.63%,93.37%,4486,2122,12,55,15,11,
0500000US13199,"Meriwether County, Georgia",21080,10895,51.68%,48.32%,41.2,1918,9.10%,687,595,0,5987,806,1009,594,12116,1603,6674,1401,1009,31.66%,6.65%,5%,475,20138,2.25%,97.75%,12084,7273,64,78,6,50,
0500000US13201,"Miller County, Georgia",5725,2961,51.72%,48.28%,51.2,320,5.59%,171,170,30,1171,521,445,298,3404,743,1342,691,475,23.44%,12.07%,8%,136,5864,2.38%,97.62%,3949,1748,9,26,1,5,
0500000US13205,"Mitchell County, Georgia",22072,10669,48.34%,51.66%,35.3,2397,10.86%,505,825,78,5996,1165,1143,648,12287,1791,6501,1990,1221,29.45%,9.02%,6%,964,20791,4.37%,95.63%,10106,10054,37,108,0,41,
0500000US13207,"Monroe County, Georgia",27455,13592,49.51%,50.49%,54.2,1433,5.22%,1037,801,231,6515,1227,2537,2572,16682,5109,7552,2028,2768,27.51%,7.39%,10%,714,27243,2.60%,97.40%,19954,6084,34,239,0,86,
0500000US13209,"Montgomery County, Georgia",9069,4515,49.79%,50.22%,49.2,427,4.71%,326,688,9,2297,580,546,447,5024,993,2623,1268,555,28.92%,13.98%,6%,571,8039,6.30%,93.70%,5665,2120,11,34,0,13,
0500000US13211,"Morgan County, Georgia",18832,9568,50.81%,49.19%,55.4,592,3.14%,541,355,54,4887,939,1811,1416,11841,3227,5428,1294,1865,28.82%,6.87%,10%,712,19385,3.78%,96.22%,14487,4105,42,122,1,68,
0500000US13213,"Murray County, Georgia",39789,20226,50.83%,49.17%,56,2524,6.34%,1223,1309,98,9105,1943,1967,857,19230,2824,10328,3252,2065,25.96%,8.17%,5%,5914,34059,14.86%,85.14%,32164,263,79,127,2,58,
0500000US13215,"Muscogee County, Georgia",195418,100181,51.27%,48.74%,39.9,18192,9.31%,6555,8531,2023,33776,11727,20940,14151,112507,35091,40331,20258,22963,20.64%,10.37%,12%,16513,190409,8.45%,91.55%,79083,94701,488,5546,517,1076,
0500000US13217,"Newton County, Georgia",109835,57931,52.74%,47.26%,47.6,5311,4.84%,5062,2989,526,22795,6096,8748,5927,61302,14675,27857,9085,9274,25.36%,8.27%,8%,7164,105319,6.52%,93.48%,46746,52246,175,1044,114,734,
0500000US13219,"Oconee County, Georgia",39194,19836,50.61%,49.39%,64.2,676,1.72%,1089,1409,229,5052,1902,6171,6828,24408,12999,6141,3311,6400,15.67%,8.45%,16%,2347,39452,5.99%,94.01%,33886,1897,31,2066,0,171,
0500000US13221,"Oglethorpe County, Georgia",15040,7395,49.17%,50.83%,51.3,582,3.87%,345,276,144,3981,1025,1129,920,8737,2049,4326,1301,1273,28.76%,8.65%,8%,869,13956,5.78%,94.22%,10903,2248,40,134,5,53,
0500000US13223,"Paulding County, Georgia",164440,84341,51.29%,48.71%,54.4,4993,3.04%,5632,4975,1087,32882,9788,17299,8386,97253,25685,38514,14763,18386,23.42%,8.98%,11%,12564,156097,7.64%,92.36%,108444,36609,394,1926,114,1068,
0500000US13225,"Peach County, Georgia",27502,14172,51.53%,48.47%,36.9,2137,7.77%,933,2433,134,5681,1952,1890,2060,15144,3950,6614,4385,2024,24.05%,15.94%,7%,2547,25434,9.26%,90.74%,12119,12139,63,194,6,98,
0500000US13227,"Pickens County, Georgia",32002,16161,50.50%,49.50%,57.1,726,2.27%,774,907,67,7787,2179,3411,1895,20484,5306,8561,3086,3478,26.75%,9.64%,11%,1198,32018,3.74%,96.26%,30122,286,85,191,4,70,
0500000US13229,"Pierce County, Georgia",19336,9660,49.96%,50.04%,48.3,1453,7.51%,736,489,8,5621,1414,938,801,10938,1739,6357,1903,946,32.88%,9.84%,5%,998,18718,5.16%,94.84%,16403,1597,41,82,0,45,
0500000US13231,"Pike County, Georgia",18565,9477,51.05%,48.95%,56.6,1047,5.64%,754,510,23,4794,988,1372,1097,11060,2469,5548,1498,1395,29.88%,8.07%,8%,348,18541,1.87%,98.13%,16313,1445,28,77,0,62,
0500000US13233,"Polk County, Georgia",42251,21576,51.07%,48.93%,49.6,3140,7.43%,1477,1450,69,10832,2166,2204,1349,22513,3553,12309,3616,2273,29.13%,8.56%,5%,5585,37268,13.22%,86.78%,30161,5119,101,239,21,156,
0500000US13235,"Pulaski County, Georgia",11185,6354,56.81%,43.19%,38.8,717,6.41%,306,289,39,3003,517,640,466,6710,1106,3309,806,679,29.58%,7.21%,6%,327,9528,2.92%,97.08%,6022,3161,8,92,3,48,
0500000US13237,"Putnam County, Georgia",21906,11150,50.90%,49.10%,54.4,1404,6.41%,668,329,43,5878,1124,2292,1459,13997,3751,6546,1453,2335,29.88%,6.63%,11%,1557,20490,7.11%,92.89%,14316,5385,33,108,1,40,
0500000US13239,"Quitman County, Georgia",2290,1127,49.21%,50.79%,52.5,194,8.47%,39,158,0,590,71,117,86,1258,203,629,229,117,27.47%,10.00%,5%,31,2204,1.35%,98.65%,1190,917,13,12,0,9,
0500000US13241,"Rabun County, Georgia",16859,8645,51.28%,48.72%,53.5,1085,6.44%,238,466,208,3815,910,1812,1881,11059,3693,4053,1376,2020,24.04%,8.16%,12%,1452,15431,8.61%,91.39%,14625,107,28,60,1,35,
0500000US13243,"Randolph County, Georgia",6888,3556,51.63%,48.37%,30.2,878,12.75%,171,207,0,1516,326,410,155,3406,565,1687,533,410,24.49%,7.74%,6%,143,6282,2.08%,97.92%,2250,3862,9,21,3,23,
0500000US13245,"Richmond County, Georgia",202178,104330,51.60%,48.40%,33,21226,10.50%,9116,9027,1400,42640,11742,18388,11515,113982,29903,51756,20769,19788,25.60%,10.27%,10%,11449,195158,5.66%,94.34%,68397,112947,511,3907,391,905,
0500000US13247,"Rockdale County, Georgia",90155,47653,52.86%,47.14%,44.7,4580,5.08%,2641,3021,712,17991,5436,10437,5871,53521,16308,20632,8457,11149,22.89%,9.38%,12%,9540,84030,10.58%,89.42%,24500,53785,168,1532,72,617,
0500000US13249,"Schley County, Georgia",5215,2656,50.93%,49.07%,56.9,346,6.63%,142,229,8,1198,321,258,161,2973,419,1340,550,266,25.70%,10.55%,5%,175,4372,3.36%,96.64%,3357,863,4,20,2,7,
0500000US13251,"Screven County, Georgia",13977,7267,51.99%,48.01%,41.4,1353,9.68%,334,469,47,3941,804,772,680,8267,1452,4275,1273,819,30.59%,9.11%,6%,287,13780,2.05%,97.95%,8018,5285,39,61,3,31,
0500000US13253,"Seminole County, Georgia",8218,4365,53.12%,46.89%,40.6,998,12.14%,199,183,0,2232,543,647,274,5023,921,2431,726,647,29.58%,8.83%,8%,228,8919,2.77%,97.23%,5617,2961,6,61,0,25,
0500000US13255,"Spalding County, Georgia",66043,34282,51.91%,48.09%,44.8,4964,7.52%,2219,1663,430,18560,2889,5067,3108,37506,8175,20779,4552,5497,31.46%,6.89%,8%,3666,63640,5.55%,94.45%,37105,23148,154,640,23,247,
0500000US13257,"Stephens County, Georgia",25934,13797,53.20%,46.80%,47.8,1400,5.40%,925,1216,203,6997,1124,1815,1362,14377,3177,7922,2340,2018,30.55%,9.02%,8%,857,25927,3.30%,96.70%,21323,2936,73,225,9,76,
0500000US13259,"Stewart County, Georgia",6446,2063,32.00%,68.00%,34.3,234,3.63%,160,204,18,1825,198,416,278,3703,694,1985,402,434,30.79%,6.24%,7%,1217,4097,18.88%,81.12%,1338,2461,10,167,5,8,
0500000US13261,"Sumter County, Georgia",29714,15616,52.55%,47.45%,40.1,2636,8.87%,1009,2369,224,6689,1687,1921,1848,15886,3769,7698,4056,2145,25.91%,13.65%,7%,1770,27846,5.96%,94.04%,11528,15051,40,503,4,55,
0500000US13263,"Talbot County, Georgia",6245,3239,51.87%,48.14%,42.4,292,4.68%,234,174,6,2050,385,295,297,3885,592,2284,559,301,36.57%,8.95%,5%,112,5621,1.79%,98.21%,2427,3056,5,17,1,6,
0500000US13265,"Taliaferro County, Georgia",1596,834,52.26%,47.74%,36.6,90,5.64%,63,37,0,631,45,51,21,977,72,694,82,51,43.48%,5.14%,3%,69,1490,4.32%,95.68%,591,833,4,6,0,2,
0500000US13267,"Tattnall County, Georgia",25392,10456,41.18%,58.82%,40.6,1617,6.37%,928,472,89,7135,1317,1389,1137,13921,2526,8063,1789,1478,31.75%,7.05%,6%,2303,20539,9.07%,90.93%,13825,5961,36,127,6,46,
0500000US13269,"Taylor County, Georgia",8126,4363,53.69%,46.31%,44.2,1349,16.60%,155,155,0,2361,512,491,267,4807,758,2516,667,491,30.96%,8.21%,6%,168,7648,2.07%,97.93%,4584,2807,27,29,2,19,
0500000US13271,"Telfair County, Georgia",15871,6514,41.04%,58.96%,34.6,1321,8.32%,545,434,0,5902,692,456,372,8523,828,6447,1126,456,40.62%,7.09%,3%,1928,10549,12.15%,87.85%,5970,4326,28,30,0,17,
0500000US13273,"Terrell County, Georgia",8654,4359,50.37%,49.63%,39.4,1073,12.40%,259,243,18,2004,432,338,270,4556,608,2263,675,356,26.15%,7.80%,4%,177,9008,2.05%,97.95%,3189,5540,11,57,1,11,
0500000US13275,"Thomas County, Georgia",44545,23272,52.24%,47.76%,47.1,3096,6.95%,1219,1243,378,9447,3056,4301,3049,26229,7350,10666,4299,4679,23.94%,9.65%,11%,1577,44221,3.54%,96.46%,25994,16259,150,406,9,124,
0500000US13277,"Tift County, Georgia",40590,20865,51.40%,48.60%,45.5,3714,9.15%,1040,3040,14,8823,3511,2064,2415,21583,4479,9863,6551,2078,24.30%,16.14%,5%,5219,36125,12.86%,87.14%,22189,12049,56,650,2,91,
0500000US13279,"Toombs County, Georgia",26947,14448,53.62%,46.38%,48.9,2654,9.85%,1115,879,9,6325,1377,1640,1270,14642,2910,7440,2256,1649,27.61%,8.37%,6%,3044,23986,11.30%,88.70%,16007,6980,31,207,6,79,
0500000US13281,"Towns County, Georgia",11815,6284,53.19%,46.81%,59.2,436,3.69%,544,841,125,2394,820,1558,1266,7947,2824,2938,1661,1683,24.87%,14.06%,14%,415,12078,3.51%,96.49%,11469,124,28,81,3,35,
0500000US13283,"Treutlen County, Georgia",6787,3133,46.16%,53.84%,45.3,951,14.01%,203,228,15,1858,299,522,216,3459,738,2061,527,537,30.37%,7.76%,8%,170,6236,2.50%,97.50%,4065,1999,19,7,0,7,
0500000US13285,"Troup County, Georgia",70095,36623,52.25%,47.75%,44.8,5747,8.20%,2294,1948,904,16149,4002,5852,3414,39309,9266,18443,5950,6756,26.31%,8.49%,10%,2956,66470,4.22%,95.78%,38099,24157,127,1608,36,239,
0500000US13287,"Turner County, Georgia",7920,4210,53.16%,46.84%,48.4,1115,14.08%,73,251,12,1930,820,345,259,4426,604,2003,1071,357,25.29%,13.52%,5%,372,8634,4.70%,95.30%,4700,3644,7,49,0,25,
0500000US13289,"Twiggs County, Georgia",8195,4131,50.41%,49.59%,47.1,454,5.54%,78,91,17,2620,465,329,315,4979,644,2698,556,346,32.92%,6.78%,4%,124,7898,1.51%,98.49%,4487,3099,16,37,0,18,
0500000US13291,"Union County, Georgia",23999,12424,51.77%,48.23%,60.4,1949,8.12%,448,619,99,6783,1585,2435,1823,16745,4258,7231,2204,2534,30.13%,9.18%,11%,816,23816,3.40%,96.60%,22646,126,74,100,0,63,
0500000US13293,"Upson County, Georgia",26329,13769,52.30%,47.70%,40.9,3076,11.68%,920,730,134,6835,1751,1591,909,15190,2500,7755,2481,1725,29.45%,9.42%,7%,633,27067,2.40%,97.60%,18009,7851,63,151,1,106,
0500000US13295,"Walker County, Georgia",69398,35233,50.77%,49.23%,50.5,3937,5.67%,1972,2682,106,16670,3984,5768,3578,40555,9346,18642,6666,5874,26.86%,9.61%,8%,1685,65969,2.43%,97.57%,59654,2840,149,293,25,204,
0500000US13297,"Walton County, Georgia",93284,48003,51.46%,48.54%,53.1,3923,4.21%,3757,2277,343,21851,4802,8752,5317,54537,14069,25608,7079,9095,27.45%,7.59%,10%,5228,91445,5.60%,94.40%,68499,17136,188,1409,44,552,
0500000US13299,"Ware County, Georgia",35745,17652,49.38%,50.62%,41.5,2775,7.76%,1336,534,144,9903,1885,2479,1224,19880,3703,11239,2419,2623,31.44%,6.77%,7%,1612,34639,4.51%,95.49%,22275,10703,77,333,18,112,
0500000US13301,"Warren County, Georgia",5259,2789,53.03%,46.97%,40.6,625,11.88%,136,91,11,1611,228,276,135,2927,411,1747,319,287,33.22%,6.07%,5%,53,5162,1.01%,98.99%,1974,3047,18,15,1,10,
0500000US13303,"Washington County, Georgia",20316,9974,49.09%,50.91%,40,1709,8.41%,662,674,58,6646,880,1445,710,12021,2155,7308,1554,1503,35.97%,7.65%,7%,334,19654,1.64%,98.36%,8412,10698,37,76,0,30,
0500000US13305,"Wayne County, Georgia",29959,14864,49.61%,50.39%,50.5,2044,6.82%,826,717,42,8544,2097,1492,1048,17048,2540,9370,2814,1534,31.28%,9.39%,5%,1732,28412,5.78%,94.22%,21301,5877,58,174,2,130,
0500000US13307,"Webster County, Georgia",2587,1319,50.99%,49.01%,49.1,237,9.16%,30,27,73,597,179,108,95,1473,203,627,206,181,24.24%,7.96%,7%,59,2289,2.28%,97.72%,1136,1063,0,12,6,3,
0500000US13309,"Wheeler County, Georgia",7897,2773,35.12%,64.89%,32.2,1053,13.33%,956,332,0,1748,144,627,19,3203,646,2704,476,627,34.24%,6.03%,8%,272,7199,3.44%,96.56%,4157,2875,9,17,0,6,
0500000US13311,"White County, Georgia",29962,15412,51.44%,48.56%,55.7,1769,5.90%,1175,859,90,6872,1762,2608,1780,18382,4388,8047,2621,2698,26.86%,8.75%,9%,913,27090,3.05%,96.95%,24959,467,105,159,0,116,
0500000US13313,"Whitfield County, Georgia",104122,52414,50.34%,49.66%,50.3,4718,4.53%,3773,3661,727,20683,3617,6983,4067,48089,11050,24456,7278,7710,23.49%,6.99%,7%,36916,65948,35.45%,64.55%,57875,3553,182,1394,19,304,
0500000US13315,"Wilcox County, Georgia",8701,3467,39.85%,60.15%,38.3,802,9.22%,332,160,26,2743,520,364,398,5295,762,3075,680,390,35.34%,7.82%,4%,272,8494,3.13%,96.87%,5185,3096,3,49,3,9,
0500000US13317,"Wilkes County, Georgia",9797,4967,50.70%,49.30%,43,849,8.67%,310,231,21,3189,438,447,351,5707,798,3499,669,468,35.72%,6.83%,5%,399,9166,4.07%,95.93%,4952,3838,22,59,0,18,
0500000US13319,"Wilkinson County, Georgia",8945,4731,52.89%,47.11%,39.4,1148,12.83%,219,208,88,3114,392,426,269,5352,695,3333,600,514,37.26%,6.71%,6%,239,8638,2.67%,97.33%,5110,3163,30,22,3,13,
0500000US13321,"Worth County, Georgia",20346,10589,52.05%,47.96%,53.3,1613,7.93%,664,720,22,6153,1745,907,563,12088,1470,6817,2465,929,33.51%,12.12%,5%,381,20403,1.87%,98.13%,14427,5255,49,87,8,53,
0500000US15001,"Hawaii County, Hawaii",201350,101428,50.37%,49.63%,49.4,13693,6.80%,5817,6143,1000,43473,16267,28103,14329,133526,42432,49290,22410,29103,24.48%,11.13%,14%,22275,178354,11.06%,88.94%,64688,1159,649,38351,26185,1000,
0500000US15003,"Honolulu County, Hawaii",979682,486148,49.62%,50.38%,49.7,39356,4.02%,36366,40177,8747,175427,74216,157631,85851,630155,243482,211793,114393,166378,21.62%,11.68%,17%,92322,924186,9.42%,90.58%,175530,19356,1116,429410,97063,3174,
0500000US15005,"Kalawao County, Hawaii",436,182,41.74%,58.26%,65.5,4,0.92%,0,2,0,132,115,166,5,427,171,132,117,166,30.28%,26.83%,38%,18,64,4.13%,95.87%,27,0,0,9,15,4,
0500000US15007,"Kauai County, Hawaii",71949,36314,50.47%,49.53%,50.1,2880,4.00%,1989,2025,404,15911,6485,10429,4272,47590,14701,17900,8510,10833,24.88%,11.83%,15%,7394,65904,10.28%,89.72%,22194,352,156,20504,6825,283,
0500000US15009,"Maui County, Hawaii",166657,83752,50.25%,49.75%,50.6,7680,4.61%,5383,4044,747,37088,11137,22350,11353,109850,33703,42471,15181,23097,25.48%,9.11%,14%,16914,147840,10.15%,89.85%,51926,1010,400,43284,18966,822,
0500000US16001,"Ada County, Idaho",469473,234388,49.93%,50.07%,52.7,20256,4.31%,13637,18915,4333,66307,30972,84327,43104,303186,127431,79944,49887,88660,17.03%,10.63%,19%,45223,449744,9.63%,90.37%,397998,7733,2269,13651,1219,2485,
0500000US16003,"Adams County, Idaho",4200,2019,48.07%,51.93%,61.2,260,6.19%,77,85,28,1195,241,393,227,3065,620,1272,326,421,30.29%,7.76%,10%,152,4227,3.62%,96.38%,3992,3,27,8,0,18,
0500000US16005,"Bannock County, Idaho",86742,43402,50.04%,49.96%,50.5,5104,5.88%,2806,4411,781,15065,5670,10151,4756,51062,14907,17871,10081,10932,20.60%,11.62%,13%,7993,79025,9.21%,90.79%,70447,688,2600,1148,249,371,
0500000US16007,"Bear Lake County, Idaho",6054,3014,49.79%,50.22%,67.8,251,4.15%,208,157,48,1447,430,536,195,3750,731,1655,587,584,27.34%,9.70%,10%,208,6164,3.44%,96.56%,5977,10,25,13,2,0,
0500000US16009,"Benewah County, Idaho",9231,4568,49.49%,50.52%,53.9,534,5.78%,306,164,25,2410,642,797,367,5735,1164,2716,806,822,29.42%,8.73%,9%,254,9276,2.75%,97.25%,7773,8,796,30,15,70,
0500000US16011,"Bingham County, Idaho",46246,23098,49.95%,50.05%,57.3,1400,3.03%,1952,1368,166,9223,2949,3963,1749,24929,5712,11175,4317,4129,24.16%,9.33%,9%,8331,39661,18.01%,81.99%,34937,115,2892,192,38,138,
0500000US16013,"Blaine County, Idaho",22729,11156,49.08%,50.92%,57.3,880,3.87%,778,516,187,3716,1047,4350,2030,14385,6380,4494,1563,4537,19.77%,6.88%,20%,5021,19251,22.09%,77.91%,18024,45,34,211,15,116,
0500000US16015,"Boise County, Idaho",7625,3777,49.53%,50.47%,62.6,550,7.21%,144,148,31,1804,799,1056,650,5646,1706,1948,947,1087,25.55%,12.42%,14%,324,7286,4.25%,95.75%,6751,19,55,36,4,84,
0500000US16017,"Bonner County, Idaho",44688,22470,50.28%,49.72%,59.5,2010,4.50%,1214,585,89,9777,3193,5859,3012,30471,8871,10991,3778,5948,24.59%,8.45%,13%,1504,45606,3.37%,96.63%,42344,115,307,252,39,295,
0500000US16019,"Bonneville County, Idaho",116970,58394,49.92%,50.08%,55.7,4344,3.71%,3922,3660,716,17876,7119,15056,6900,65615,21956,21798,10779,15772,18.64%,9.22%,13%,17094,106870,14.61%,85.39%,99943,593,677,1392,145,395,
0500000US16021,"Boundary County, Idaho",12156,6052,49.79%,50.21%,53.4,1042,8.57%,536,244,31,3655,519,1079,425,7712,1504,4191,763,1110,34.48%,6.28%,9%,692,11364,5.69%,94.31%,10550,27,145,72,9,71,
0500000US16023,"Butte County, Idaho",2603,1199,46.06%,53.94%,59.6,249,9.57%,3,38,0,637,217,255,82,1801,337,640,255,255,24.59%,9.80%,10%,134,2440,5.15%,94.85%,2336,2,15,3,2,2,
0500000US16025,"Camas County, Idaho",1069,573,53.60%,46.40%,47.4,14,1.31%,14,0,0,263,78,119,56,656,175,277,78,119,25.91%,7.30%,11%,59,1018,5.52%,94.48%,938,2,0,8,0,5,
0500000US16027,"Canyon County, Idaho",223890,112760,50.36%,49.64%,53.3,13188,5.89%,8898,7877,1697,43120,11168,20055,7942,119819,27997,52018,19045,21752,23.23%,8.51%,10%,59166,171939,26.43%,73.57%,155401,1455,1176,1973,620,1120,
0500000US16029,"Caribou County, Idaho",7028,3366,47.89%,52.11%,63.4,99,1.41%,240,164,58,1528,459,562,227,4079,789,1768,623,620,25.16%,8.86%,9%,384,6643,5.46%,94.54%,6391,0,46,9,15,14,
0500000US16031,"Cassia County, Idaho",23847,11666,48.92%,51.08%,59.4,1470,6.16%,943,626,92,4104,1453,2046,734,12155,2780,5047,2079,2138,21.16%,8.72%,9%,7186,17469,30.13%,69.87%,16522,64,122,131,29,80,
0500000US16033,"Clark County, Idaho",885,395,44.63%,55.37%,45.3,33,3.73%,21,13,6,176,29,68,26,362,94,197,42,74,22.26%,4.75%,8%,288,502,32.54%,67.46%,463,3,2,1,0,2,
0500000US16035,"Clearwater County, Idaho",8735,3901,44.66%,55.34%,49,361,4.13%,255,164,29,2349,625,788,388,6260,1176,2604,789,817,29.81%,9.03%,9%,300,8434,3.43%,96.57%,7882,40,133,45,2,35,
0500000US16037,"Custer County, Idaho",4193,2076,49.51%,50.49%,60.8,434,10.35%,89,198,7,737,347,810,108,2760,918,826,545,817,19.70%,13.00%,19%,156,4119,3.72%,96.28%,3893,3,32,15,1,19,
0500000US16039,"Elmore County, Idaho",27043,12858,47.55%,52.45%,55,1745,6.45%,1394,1227,70,4885,2191,2567,953,15376,3520,6279,3418,2637,23.22%,12.64%,10%,5097,23569,18.85%,81.15%,19996,688,234,766,101,145,
0500000US16041,"Franklin County, Idaho",13736,6664,48.52%,51.49%,64.1,479,3.49%,485,331,117,3516,635,864,532,7476,1396,4001,966,981,29.13%,7.03%,7%,1023,13171,7.45%,92.55%,12701,22,75,28,7,20,
0500000US16043,"Fremont County, Idaho",13111,6293,48.00%,52.00%,63.2,476,3.63%,412,554,16,2538,980,1217,468,7607,1685,2950,1534,1233,22.50%,11.70%,9%,1590,11798,12.13%,87.87%,11292,21,68,44,24,34,
0500000US16045,"Gem County, Idaho",17771,9004,50.67%,49.33%,55.2,449,2.53%,662,392,103,4474,881,1697,642,10840,2339,5136,1273,1800,28.90%,7.16%,10%,1722,17401,9.69%,90.31%,16132,29,124,99,20,96,
0500000US16047,"Gooding County, Idaho",15280,7434,48.65%,51.35%,53.7,651,4.26%,570,362,8,3629,663,1171,493,7943,1664,4199,1025,1179,27.48%,6.71%,8%,4847,10751,31.72%,68.28%,10044,20,70,40,4,52,
0500000US16049,"Idaho County, Idaho",16511,7814,47.33%,52.67%,60,640,3.88%,525,294,11,4301,1395,1957,572,11286,2529,4826,1689,1968,29.23%,10.23%,12%,611,15930,3.70%,96.30%,14656,54,414,55,5,94,
0500000US16051,"Jefferson County, Idaho",29238,14405,49.27%,50.73%,61.9,890,3.04%,1229,994,50,4165,2757,2888,1352,15359,4240,5394,3751,2938,18.45%,12.83%,10%,3256,27635,11.14%,88.86%,26430,73,127,118,30,106,
0500000US16053,"Jerome County, Idaho",24074,11909,49.47%,50.53%,54.9,1945,8.08%,888,497,49,4482,1573,1431,737,11469,2168,5370,2070,1480,22.31%,8.60%,6%,9176,15061,38.12%,61.88%,14153,39,110,80,22,70,
0500000US16055,"Kootenai County, Idaho",161676,81597,50.47%,49.53%,58.1,6121,3.79%,5126,4495,362,30196,11587,19906,10062,105752,29968,35322,16082,20268,21.85%,9.95%,13%,8756,162606,5.42%,94.58%,149107,463,1715,1371,195,927,
0500000US16057,"Latah County, Idaho",40052,19590,48.91%,51.09%,45.6,3705,9.25%,1509,6193,1610,4646,1797,5901,4312,22175,10213,6155,7990,7511,15.37%,19.95%,19%,2073,37444,5.18%,94.82%,33476,318,263,968,48,227,
0500000US16059,"Lemhi County, Idaho",7929,3845,48.49%,51.51%,55.3,287,3.62%,212,112,2,1667,559,919,500,5576,1419,1879,671,921,23.70%,8.46%,12%,295,7679,3.72%,96.28%,7280,17,46,28,6,38,
0500000US16061,"Lewis County, Idaho",3850,1956,50.81%,49.20%,52.1,230,5.97%,96,71,9,761,344,367,159,2454,526,857,415,376,22.26%,10.78%,10%,138,3395,3.58%,96.42%,3031,6,181,7,1,12,
0500000US16063,"Lincoln County, Idaho",5342,2519,47.16%,52.85%,54.8,367,6.87%,114,163,47,1076,446,260,121,2708,381,1190,609,307,22.28%,11.40%,6%,1639,3488,30.68%,69.32%,3245,6,22,10,4,5,
0500000US16065,"Madison County, Idaho",39725,19527,49.16%,50.85%,61.6,5156,12.98%,2630,8164,906,2428,2554,4647,1827,15985,6474,5058,10718,5553,12.73%,26.98%,14%,5248,47665,13.21%,86.79%,43985,709,153,933,215,165,
0500000US16067,"Minidoka County, Idaho",20817,10393,49.93%,50.07%,58,953,4.58%,855,481,36,4075,1277,1122,679,10158,1801,4930,1758,1158,23.68%,8.45%,6%,7909,13704,37.99%,62.01%,12946,27,92,51,10,57,
0500000US16069,"Nez Perce County, Idaho",40468,20440,50.51%,49.49%,53.6,1973,4.88%,1151,1672,195,8694,3189,4820,1999,26207,6819,9845,4861,5015,24.33%,12.01%,12%,1630,40460,4.03%,95.97%,35436,184,2336,324,32,126,
0500000US16071,"Oneida County, Idaho",4429,2202,49.72%,50.28%,65.4,172,3.88%,88,120,57,930,207,527,103,2577,630,1018,327,584,22.98%,7.38%,13%,178,4386,4.02%,95.98%,4259,2,14,14,4,8,
0500000US16073,"Owyhee County, Idaho",11724,5565,47.47%,52.53%,59.9,466,3.97%,464,266,34,2454,549,735,224,5729,959,2918,815,769,24.89%,6.95%,7%,2915,8998,24.86%,75.14%,8060,28,374,42,8,68,
0500000US16075,"Payette County, Idaho",23705,11928,50.32%,49.68%,57.1,887,3.74%,929,590,15,5851,1349,1855,706,13535,2561,6780,1939,1870,28.60%,8.18%,8%,4268,21118,18.00%,82.00%,19240,52,163,207,31,133,
0500000US16077,"Power County, Idaho",7635,3799,49.76%,50.24%,55.3,290,3.80%,253,155,103,1663,226,449,292,3770,741,1916,381,552,25.09%,4.99%,7%,2624,5254,34.37%,65.63%,4826,17,172,18,8,22,
0500000US16079,"Shoshone County, Idaho",12700,6421,50.56%,49.44%,50.6,770,6.06%,447,281,35,3458,989,625,351,7999,976,3905,1270,660,30.75%,10.00%,5%,450,12719,3.54%,96.46%,11771,15,145,53,6,83,
0500000US16081,"Teton County, Idaho",11776,5735,48.70%,51.30%,55.4,312,2.65%,267,467,83,1341,655,2345,938,7382,3283,1608,1122,2428,13.65%,9.53%,21%,2020,9610,17.15%,82.85%,9141,16,25,51,0,37,
0500000US16083,"Twin Falls County, Idaho",86198,43775,50.78%,49.22%,56.3,4065,4.72%,2997,3001,327,14784,6440,7901,4913,48126,12814,17781,9441,8228,20.63%,10.95%,10%,15210,74836,17.65%,82.35%,68169,1021,499,1403,201,267,
0500000US16085,"Valley County, Idaho",11085,5542,50.00%,50.01%,52.8,262,2.36%,85,134,203,2142,702,1828,803,7949,2631,2227,836,2031,20.09%,7.54%,18%,601,11145,5.42%,94.58%,10467,16,54,55,8,78,
0500000US16087,"Washington County, Idaho",10128,5115,50.50%,49.50%,55.4,718,7.09%,244,258,39,2172,774,823,539,6269,1362,2416,1032,862,23.85%,10.19%,9%,1662,8838,16.41%,83.59%,8118,17,74,81,7,53,
0500000US17001,"Adams County, Illinois",65670,33429,50.91%,49.10%,53.9,3477,5.29%,2062,1954,458,15776,4140,7537,4024,42281,11561,17838,6094,7995,27.16%,9.28%,12%,1287,64450,1.96%,98.04%,58389,2464,92,500,33,223,
0500000US17003,"Alexander County, Illinois",6011,3134,52.14%,47.86%,42.2,600,9.98%,160,77,0,1661,445,380,114,3678,494,1821,522,380,30.29%,8.68%,6%,82,5158,1.36%,98.64%,3274,1612,22,6,0,8,
0500000US17005,"Bond County, Illinois",16520,7829,47.39%,52.61%,51,859,5.20%,376,1032,46,3926,1245,1568,1006,10650,2574,4302,2277,1614,26.04%,13.78%,10%,604,16121,3.66%,96.34%,14264,1073,52,94,11,93,
0500000US17007,"Boone County, Illinois",53293,26775,50.24%,49.76%,51.7,1924,3.61%,1476,2582,248,11331,2915,5125,3364,30429,8489,12807,5497,5373,24.03%,10.31%,10%,12880,40568,24.17%,75.83%,36689,1171,72,637,9,181,
0500000US17009,"Brown County, Illinois",6599,2419,36.66%,63.34%,41,127,1.92%,215,191,54,1889,356,494,126,3977,620,2104,547,548,31.88%,8.29%,8%,282,5962,4.27%,95.73%,4764,1035,7,11,0,2,
0500000US17011,"Bureau County, Illinois",32878,16725,50.87%,49.13%,54.8,1404,4.27%,930,978,192,8426,2225,3234,1607,21210,4841,9356,3203,3426,28.46%,9.74%,10%,3095,30149,9.41%,90.59%,28511,259,49,298,21,51,
0500000US17013,"Calhoun County, Illinois",4782,2360,49.35%,50.65%,55.8,150,3.14%,113,135,38,1449,558,334,212,3256,546,1562,693,372,32.66%,14.49%,8%,64,4373,1.34%,98.66%,4217,7,4,7,0,6,
0500000US17015,"Carroll County, Illinois",14398,7171,49.81%,50.19%,56.1,665,4.62%,519,325,94,4020,947,1385,725,9637,2110,4539,1272,1479,31.53%,8.83%,10%,757,14945,5.26%,94.74%,13743,676,49,40,5,32,
0500000US17017,"Cass County, Illinois",12324,6237,50.61%,49.39%,53.4,716,5.81%,412,289,11,3393,625,974,361,6966,1335,3805,914,985,30.87%,7.42%,8%,2789,10253,22.63%,77.37%,9061,706,36,117,33,10,
0500000US17019,"Champaign County, Illinois",210006,105163,50.08%,49.92%,39.1,24995,11.90%,8093,29513,8810,26809,10139,25835,29324,116216,55159,34902,39652,34645,16.62%,18.88%,16%,16666,189199,7.94%,92.06%,125280,28215,279,24420,60,897,
0500000US17021,"Christian County, Illinois",32705,16102,49.23%,50.77%,48.1,1600,4.89%,743,935,319,9454,2401,3023,1231,20927,4254,10197,3336,3342,31.18%,10.20%,10%,1094,32938,3.35%,96.65%,31226,380,59,179,1,60,
0500000US17023,"Clark County, Illinois",15602,7816,50.10%,49.90%,59.9,399,2.56%,463,360,171,4266,1515,1517,868,10177,2385,4729,1875,1688,30.31%,12.02%,11%,246,15209,1.58%,98.42%,14680,54,28,52,0,30,
0500000US17025,"Clay County, Illinois",13217,6653,50.34%,49.66%,52.3,786,5.95%,298,401,75,3550,1150,911,515,8148,1426,3848,1551,986,29.11%,11.73%,7%,223,13065,1.69%,98.31%,12481,30,33,77,0,18,
0500000US17027,"Clinton County, Illinois",37549,18023,48.00%,52.00%,52.6,1132,3.01%,1185,936,306,8633,3998,4054,1755,24138,5809,9818,4934,4360,26.15%,13.14%,12%,1387,35512,3.69%,96.31%,32845,1140,80,175,5,93,
0500000US17029,"Coles County, Illinois",51065,26326,51.55%,48.45%,40.9,4701,9.21%,2150,5295,964,10219,3682,5011,3559,29887,8570,12369,8977,5975,24.22%,17.58%,12%,1768,45095,3.46%,96.54%,40352,2043,82,617,24,211,
0500000US17031,"Cook County, Illinois",5169517,2659831,51.45%,48.55%,42.3,317488,6.14%,128409,191084,83105,811264,238063,846361,587058,3142885,1433419,939673,429147,929466,18.18%,8.30%,18%,1382778,3892763,26.75%,73.25%,2135243,1185601,5655,408691,961,20538,
0500000US17033,"Crawford County, Illinois",18833,8751,46.47%,53.53%,52.7,965,5.12%,520,408,95,4000,2360,1550,741,11928,2291,4520,2768,1645,24.00%,14.70%,9%,447,18232,2.37%,97.63%,16941,608,36,76,2,29,
0500000US17035,"Cumberland County, Illinois",10787,5325,49.37%,50.64%,60.6,414,3.84%,227,366,37,3065,1007,1034,403,7000,1437,3292,1373,1071,30.52%,12.73%,10%,112,10338,1.04%,98.96%,9947,28,13,21,0,17,
0500000US17037,"DeKalb County, Illinois",104588,52799,50.48%,49.52%,41.4,9336,8.93%,4080,12249,2300,15693,6410,12476,7533,56942,20009,19773,18659,14776,18.91%,17.84%,14%,13597,86823,13.00%,87.00%,71249,8730,119,2280,29,298,
0500000US17039,"De Witt County, Illinois",15764,7974,50.58%,49.42%,52.6,664,4.21%,333,389,80,4449,932,1648,639,10407,2287,4782,1321,1728,30.33%,8.38%,11%,510,15006,3.24%,96.76%,14370,108,19,40,16,16,
0500000US17041,"Douglas County, Illinois",19551,9835,50.30%,49.70%,55.7,940,4.81%,464,560,104,4335,1219,1865,759,10923,2624,4799,1779,1969,24.55%,9.10%,10%,1565,18175,8.00%,92.00%,17420,67,28,103,6,34,
0500000US17043,"DuPage County, Illinois",926005,470956,50.86%,49.14%,55.8,26876,2.90%,21279,34800,16049,115694,46012,194631,125421,593465,320052,136973,80812,210680,14.79%,8.73%,23%,144291,788586,15.58%,84.42%,591441,44201,873,118982,219,3299,
0500000US17045,"Edgar County, Illinois",17272,8735,50.57%,49.43%,57.3,738,4.27%,499,550,122,4875,1464,1600,668,11353,2268,5374,2014,1722,31.11%,11.66%,10%,225,16641,1.30%,98.70%,16005,82,17,51,0,33,
0500000US17047,"Edwards County, Illinois",6431,3271,50.86%,49.14%,55.8,344,5.35%,133,175,20,1554,837,459,145,4176,604,1687,1012,479,26.23%,15.74%,7%,63,6182,0.98%,99.02%,5994,16,8,21,4,11,
0500000US17049,"Effingham County, Illinois",34151,17148,50.21%,49.79%,55,1251,3.66%,840,1055,264,7962,3412,3794,1659,21883,5453,8802,4467,4058,25.77%,13.08%,12%,872,33796,2.55%,97.45%,32361,151,36,246,6,45,
0500000US17051,"Fayette County, Illinois",21418,10097,47.14%,52.86%,50.8,1598,7.46%,788,563,68,6076,1839,1355,525,13150,1880,6864,2402,1423,32.05%,11.21%,7%,657,20831,3.07%,96.93%,19425,780,80,67,1,31,
0500000US17053,"Ford County, Illinois",13155,6668,50.69%,49.31%,53.9,789,6.00%,367,318,93,3314,944,1285,712,8416,1997,3681,1262,1378,27.98%,9.59%,10%,554,12980,4.21%,95.79%,12265,75,24,57,0,42,
0500000US17055,"Franklin County, Illinois",38688,19611,50.69%,49.31%,49.7,2886,7.46%,943,1034,129,8999,3100,3265,1397,24334,4662,9942,4134,3394,25.70%,10.69%,9%,642,37162,1.66%,98.34%,35210,162,92,119,4,63,
0500000US17057,"Fulton County, Illinois",34654,16708,48.21%,51.79%,47.1,2320,6.69%,733,1124,262,9165,2581,3151,1472,22551,4623,9898,3705,3413,28.56%,10.69%,10%,738,32871,2.13%,97.87%,30616,1102,59,69,6,77,
0500000US17059,"Gallatin County, Illinois",4983,2554,51.25%,48.75%,53,442,8.87%,129,129,15,1407,354,274,145,3142,419,1536,483,289,30.82%,9.69%,6%,53,4893,1.06%,98.94%,4683,25,5,23,0,3,
0500000US17061,"Greene County, Illinois",12988,6434,49.54%,50.46%,50.6,735,5.66%,453,333,64,4293,929,1020,394,8572,1414,4746,1262,1084,36.54%,9.72%,8%,106,11879,0.82%,99.18%,11451,18,13,21,3,23,
0500000US17063,"Grundy County, Illinois",50798,25402,50.01%,49.99%,57,1312,2.58%,1686,1498,415,10766,3196,5657,2971,31750,8628,12452,4694,6072,24.51%,9.24%,12%,5712,46821,11.24%,88.76%,43472,833,48,466,16,122,
0500000US17065,"Hamilton County, Illinois",8151,4153,50.95%,49.05%,57,727,8.92%,133,315,66,1773,595,727,508,5040,1235,1906,910,793,23.38%,11.16%,10%,96,7897,1.18%,98.82%,7574,36,16,12,0,1,
0500000US17067,"Hancock County, Illinois",17820,8958,50.27%,49.73%,57.1,853,4.79%,447,560,51,4662,1623,2033,837,12038,2870,5109,2183,2084,28.67%,12.25%,12%,318,17302,1.78%,98.22%,16599,73,38,57,4,29,
0500000US17069,"Hardin County, Illinois",3890,1866,47.97%,52.03%,49,186,4.78%,225,64,0,1088,492,225,113,2614,338,1313,556,225,33.75%,14.29%,6%,65,3584,1.67%,98.33%,3374,11,0,17,2,4,
0500000US17071,"Henderson County, Illinois",6737,3404,50.53%,49.47%,59.6,227,3.37%,181,152,71,2110,533,662,222,4643,884,2291,685,733,34.01%,10.17%,11%,112,6275,1.66%,98.34%,6060,29,5,14,5,0,
0500000US17073,"Henry County, Illinois",49032,24743,50.46%,49.54%,55,2114,4.31%,1573,1371,345,11742,4318,5679,2509,31871,8188,13315,5689,6024,27.16%,11.60%,12%,3170,46114,6.47%,93.53%,43094,1029,63,192,12,94,
0500000US17075,"Iroquois County, Illinois",27437,14079,51.31%,48.69%,54,1535,5.59%,886,641,138,7675,1902,2132,868,17157,3000,8561,2543,2270,31.20%,9.27%,8%,2085,24992,7.60%,92.40%,23602,212,38,99,0,48,
0500000US17077,"Jackson County, Illinois",57517,29124,50.64%,49.37%,37.8,6664,11.59%,1994,7482,1937,8485,3083,5674,6723,32317,12397,10479,10565,7611,18.22%,18.37%,13%,2837,50137,4.93%,95.07%,37513,7503,114,2048,24,239,
0500000US17079,"Jasper County, Illinois",9547,4751,49.76%,50.24%,58.4,490,5.13%,252,334,53,2473,1170,816,441,6200,1257,2725,1504,869,28.54%,15.75%,9%,84,9203,0.88%,99.12%,8934,22,19,15,4,19,
0500000US17081,"Jefferson County, Illinois",37774,18357,48.60%,51.40%,49.8,2391,6.33%,1174,1172,83,8248,3552,2965,1639,23599,4604,9422,4724,3048,24.94%,12.51%,8%,899,36214,2.38%,97.62%,31182,2783,77,352,7,68,
0500000US17083,"Jersey County, Illinois",21776,11115,51.04%,48.96%,50.7,717,3.29%,632,1191,233,5474,1912,2296,1379,14100,3675,6106,3103,2529,28.04%,14.25%,12%,327,21185,1.50%,98.50%,20105,156,21,74,3,32,
0500000US17085,"Jo Daviess County, Illinois",21429,10660,49.75%,50.25%,61.4,720,3.36%,469,555,107,5587,1599,2643,1602,14850,4245,6056,2154,2750,28.26%,10.05%,13%,856,21179,3.99%,96.01%,20354,114,31,96,6,52,
0500000US17087,"Johnson County, Illinois",12391,5576,45.00%,55.00%,49,557,4.50%,408,344,39,3005,911,1109,359,7527,1468,3413,1255,1148,27.54%,10.13%,9%,552,12756,4.45%,95.55%,10895,1419,20,18,4,12,
0500000US17089,"Kane County, Illinois",531756,266933,50.20%,49.80%,52.7,18079,3.40%,15707,19989,5407,79551,26363,78305,42456,298509,120761,95258,46352,83712,17.91%,8.72%,16%,169595,346927,31.89%,68.11%,282307,26239,514,21191,115,1521,
0500000US17091,"Kankakee County, Illinois",109924,55726,50.70%,49.31%,46.2,6428,5.85%,4539,5169,900,25224,6851,9433,5553,64263,14986,29763,12020,10333,27.08%,10.93%,9%,12520,94982,11.39%,88.61%,73591,15417,173,1069,13,372,
0500000US17093,"Kendall County, Illinois",127583,64607,50.64%,49.36%,55.9,2914,2.28%,3901,3716,1193,18858,8783,18732,10328,74756,29060,22759,12499,19925,17.84%,9.80%,16%,27127,104742,21.26%,78.74%,84690,9693,117,4625,10,487,
0500000US17095,"Knox County, Illinois",50052,24608,49.17%,50.84%,42.4,3352,6.70%,1551,2886,276,12303,4011,4317,2380,30928,6697,13854,6897,4593,27.68%,13.78%,9%,3051,46916,6.10%,93.90%,39615,4354,73,361,12,207,
0500000US17097,"Lake County, Illinois",699682,350168,50.05%,49.95%,55,24288,3.47%,25869,26991,10036,92200,29965,123494,87781,416524,211275,118069,56956,133530,16.87%,8.14%,19%,171962,542380,24.58%,75.42%,408349,47240,909,58901,312,3264,
0500000US17099,"LaSalle County, Illinois",108998,54114,49.65%,50.35%,50.9,6250,5.73%,3359,3237,664,27490,8360,9325,4811,68942,14136,30849,11597,9989,28.30%,10.64%,9%,11456,98202,10.51%,89.49%,90445,2514,153,855,8,297,
0500000US17101,"Lawrence County, Illinois",15830,6969,44.02%,55.98%,48.8,760,4.80%,510,297,13,4231,1581,1071,544,9833,1615,4741,1878,1084,29.95%,11.86%,7%,514,14766,3.25%,96.75%,12777,1393,12,58,7,29,
0500000US17103,"Lee County, Illinois",34204,16043,46.90%,53.10%,48.4,1525,4.46%,835,929,111,8585,2836,3096,1592,22448,4688,9420,3765,3207,27.54%,11.01%,9%,2324,31821,6.79%,93.21%,28435,1831,30,248,10,95,
0500000US17105,"Livingston County, Illinois",35757,17489,48.91%,51.09%,50.6,1470,4.11%,1212,804,156,10635,2100,2817,1375,22686,4192,11847,2904,2973,33.13%,8.12%,8%,1859,33956,5.20%,94.80%,31518,1081,38,171,1,89,
0500000US17107,"Logan County, Illinois",28818,14591,50.63%,49.37%,48.2,1197,4.15%,1151,1185,385,7369,1861,2676,1258,18115,3934,8520,3046,3061,29.56%,10.57%,11%,818,27169,2.84%,97.16%,24452,1494,48,178,1,76,
0500000US17109,"McDonough County, Illinois",30107,15538,51.61%,48.39%,39.6,3017,10.02%,1108,4787,431,5590,1931,2896,2983,17289,5879,6698,6718,3327,22.25%,22.31%,11%,962,26276,3.20%,96.80%,23062,1498,47,560,6,73,
0500000US17111,"McHenry County, Illinois",307291,154401,50.25%,49.75%,57,8799,2.86%,8140,11239,3292,54099,18992,49360,24365,195263,73725,62239,30231,52652,20.25%,9.84%,17%,46705,263524,15.20%,84.80%,238659,4073,325,8669,45,872,
0500000US17113,"McLean County, Illinois",172164,88481,51.39%,48.61%,46.1,15532,9.02%,5200,19446,3253,25297,8522,30851,15955,101045,46806,30497,27968,34104,17.71%,16.24%,20%,10524,160430,6.11%,93.89%,129440,14699,258,8108,38,618,
0500000US17115,"Macon County, Illinois",104688,54696,52.25%,47.75%,48.1,6614,6.32%,2953,3917,544,24815,6421,11316,5728,65984,17044,27768,10338,11860,26.52%,9.88%,11%,2733,101265,2.61%,97.39%,75117,18886,178,1512,31,415,
0500000US17117,"Macoupin County, Illinois",45243,22820,50.44%,49.56%,52.5,3014,6.66%,1516,1349,323,12877,3294,4059,1882,29441,5941,14393,4643,4382,31.81%,10.26%,10%,570,44397,1.26%,98.74%,41850,368,109,179,0,54,
0500000US17119,"Madison County, Illinois",264403,135581,51.28%,48.72%,51,14126,5.34%,5684,11258,2010,53471,19940,32264,19156,171753,51420,59155,31198,34274,22.37%,11.80%,13%,10797,255062,4.08%,95.92%,213793,24671,559,2718,92,825,
0500000US17121,"Marion County, Illinois",37524,19190,51.14%,48.86%,48.9,2685,7.16%,1009,1180,124,8958,3208,2731,1515,23427,4246,9967,4388,2855,26.56%,11.69%,8%,712,37017,1.90%,98.10%,33150,1509,94,349,1,97,
0500000US17123,"Marshall County, Illinois",11562,5824,50.37%,49.63%,56,472,4.08%,370,263,49,3199,868,1155,369,7741,1524,3569,1131,1204,30.87%,9.78%,10%,323,11419,2.79%,97.21%,10858,86,18,43,0,25,
0500000US17125,"Mason County, Illinois",13486,6820,50.57%,49.43%,53.2,915,6.78%,273,363,55,3926,1064,1130,486,8719,1616,4199,1427,1185,31.14%,10.58%,9%,184,12902,1.36%,98.64%,12339,49,24,26,1,11,
0500000US17127,"Massac County, Illinois",14041,7430,52.92%,47.08%,55.9,837,5.96%,182,474,35,3588,1284,1002,382,8928,1384,3770,1758,1037,26.85%,12.52%,7%,333,13836,2.37%,97.63%,12077,875,35,43,6,61,
0500000US17129,"Menard County, Illinois",12261,6272,51.15%,48.85%,62,414,3.38%,343,354,91,3022,1040,1245,771,8255,2016,3365,1394,1336,27.44%,11.37%,11%,160,12137,1.30%,98.70%,11502,80,18,49,2,25,
0500000US17131,"Mercer County, Illinois",15503,7726,49.84%,50.16%,59.3,650,4.19%,473,390,53,4472,1111,1287,708,10244,1995,4945,1501,1340,31.90%,9.68%,9%,468,15231,3.02%,96.98%,14578,68,26,37,2,17,
0500000US17133,"Monroe County, Illinois",34444,17477,50.74%,49.26%,61.8,388,1.13%,924,1112,100,6427,2258,5602,3336,23423,8938,7351,3370,5702,21.34%,9.78%,17%,646,34316,1.88%,98.12%,32680,118,53,186,2,66,
0500000US17135,"Montgomery County, Illinois",28598,13532,47.32%,52.68%,50.1,1597,5.58%,812,620,135,8248,1838,2361,1412,18347,3773,9060,2458,2496,31.68%,8.60%,9%,587,27701,2.05%,97.95%,25709,916,49,131,7,26,
0500000US17137,"Morgan County, Illinois",34012,16914,49.73%,50.27%,44.6,1606,4.72%,1308,1624,319,9429,1820,3146,1591,21322,4737,10737,3444,3465,31.57%,10.13%,10%,838,32077,2.46%,97.54%,28489,1961,54,266,16,84,
0500000US17139,"Moultrie County, Illinois",14557,7445,51.14%,48.86%,61,670,4.60%,277,297,60,3402,961,1347,667,8446,2014,3679,1258,1407,25.27%,8.64%,10%,194,14332,1.33%,98.67%,13747,84,26,49,0,25,
0500000US17141,"Ogle County, Illinois",50793,25611,50.42%,49.58%,55.1,1818,3.58%,1349,1905,202,12073,4026,5032,2692,32091,7724,13422,5931,5234,26.42%,11.68%,10%,5797,45991,11.41%,88.59%,43120,543,72,259,0,104,
0500000US17143,"Peoria County, Illinois",181111,93303,51.52%,48.48%,45,12993,7.17%,4238,7628,1984,34422,11486,23312,14623,111994,37935,38660,19114,25296,21.35%,10.55%,14%,10091,171739,5.57%,94.43%,120629,33635,342,7730,61,783,
0500000US17145,"Perry County, Illinois",21092,9500,45.04%,54.96%,47.5,1476,7.00%,629,644,77,5630,1780,1286,491,12707,1777,6259,2424,1363,29.67%,11.49%,6%,714,20231,3.39%,96.61%,17779,1653,34,125,1,34,
0500000US17147,"Piatt County, Illinois",16412,8298,50.56%,49.44%,59.5,557,3.39%,486,410,130,3849,1399,2303,1150,10861,3453,4335,1809,2433,26.41%,11.02%,15%,247,16426,1.50%,98.50%,15600,83,23,80,1,51,
0500000US17149,"Pike County, Illinois",15571,7866,50.52%,49.48%,49.4,992,6.37%,641,282,64,4475,946,1147,547,9766,1694,5116,1228,1211,32.86%,7.89%,8%,262,14477,1.68%,98.32%,13874,63,33,43,6,20,
0500000US17151,"Pope County, Illinois",4177,2016,48.26%,51.74%,46.6,529,12.66%,88,45,0,1489,224,365,195,3006,560,1577,269,365,37.75%,6.44%,9%,71,3692,1.70%,98.30%,3491,38,1,16,0,0,
0500000US17153,"Pulaski County, Illinois",5414,2777,51.29%,48.71%,47.4,474,8.76%,198,171,9,1531,343,256,194,3442,450,1729,514,265,31.94%,9.49%,5%,204,4989,3.77%,96.23%,3245,1462,36,13,0,14,
0500000US17155,"Putnam County, Illinois",5720,2804,49.02%,50.98%,57,217,3.79%,130,121,29,1549,490,503,304,3911,807,1679,611,532,29.35%,10.68%,9%,348,5289,6.08%,93.92%,5073,26,7,18,4,8,
0500000US17157,"Randolph County, Illinois",31973,14007,43.81%,56.19%,46.7,1485,4.64%,1020,821,104,8986,1927,1818,1187,19709,3005,10006,2748,1922,31.30%,8.59%,6%,1031,29132,3.22%,96.78%,25460,2381,48,86,7,72,
0500000US17159,"Richland County, Illinois",15677,7979,50.90%,49.10%,52.2,893,5.70%,310,509,48,3180,1813,1536,763,9977,2299,3490,2322,1584,22.26%,14.81%,10%,273,15540,1.74%,98.26%,14813,75,28,123,7,22,
0500000US17161,"Rock Island County, Illinois",142801,72422,50.72%,49.29%,49.1,8615,6.03%,4396,5621,1113,28670,10268,15085,8325,87415,23410,33066,15889,16198,23.16%,11.13%,11%,19842,124830,13.89%,86.11%,97689,16169,240,4033,35,482,
0500000US17163,"St. Clair County, Illinois",261186,135053,51.71%,48.29%,46.1,18131,6.94%,7838,7906,2138,49550,18443,30351,21389,163397,51740,57388,26349,32489,21.97%,10.09%,12%,12582,244818,4.82%,95.18%,150496,76013,490,3623,181,1152,
0500000US17165,"Saline County, Illinois",23735,12128,51.10%,48.90%,50.8,1798,7.58%,430,807,34,4773,2228,2297,1099,14885,3396,5203,3035,2331,21.92%,12.79%,10%,473,23295,1.99%,98.01%,21309,692,69,122,0,94,
0500000US17167,"Sangamon County, Illinois",195963,102026,52.06%,47.94%,45.9,11374,5.80%,4665,6852,2063,37590,11411,28706,17862,126157,46568,42255,18263,30769,21.56%,9.32%,16%,5309,191034,2.71%,97.29%,150467,25686,349,4300,55,727,
0500000US17169,"Schuyler County, Illinois",6897,3131,45.40%,54.60%,45.1,866,12.56%,212,78,0,1840,540,734,345,4785,1079,2052,618,734,29.75%,8.96%,11%,152,6750,2.20%,97.80%,6157,283,28,25,2,17,
0500000US17171,"Scott County, Illinois",4982,2549,51.16%,48.84%,57.8,239,4.80%,141,130,40,1680,309,574,175,3355,749,1821,439,614,36.55%,8.81%,12%,48,4901,0.96%,99.04%,4747,5,1,11,1,5,
0500000US17173,"Shelby County, Illinois",21623,11016,50.95%,49.05%,59.4,983,4.55%,664,528,104,6898,1752,1785,787,14489,2572,7562,2280,1889,34.97%,10.54%,9%,213,20777,0.99%,99.01%,20116,65,35,83,1,40,
0500000US17175,"Stark County, Illinois",5393,2740,50.81%,49.19%,55.1,276,5.12%,171,138,25,1526,394,486,218,3435,704,1697,532,511,31.47%,9.86%,9%,132,5268,2.45%,97.55%,5070,17,8,23,0,5,
0500000US17177,"Stephenson County, Illinois",44683,23079,51.65%,48.35%,52.2,2758,6.17%,1487,1319,249,10721,3256,4370,2249,29227,6619,12208,4575,4619,27.32%,10.24%,10%,2254,42376,5.04%,94.96%,35405,4374,80,306,11,155,
0500000US17179,"Tazewell County, Illinois",132524,67324,50.80%,49.20%,55.2,4981,3.76%,3670,3727,877,29623,10450,16634,7493,86553,24127,33293,14177,17511,25.12%,10.70%,13%,3161,128182,2.39%,97.61%,119882,1629,279,1080,41,324,
0500000US17181,"Union County, Illinois",16829,8331,49.50%,50.50%,52.9,1403,8.34%,413,404,59,4230,1010,1927,878,10813,2805,4643,1414,1986,27.59%,8.40%,12%,867,16377,5.15%,94.85%,15331,226,46,67,11,28,
0500000US17183,"Vermilion County, Illinois",76704,38502,50.20%,49.80%,44.3,6489,8.46%,2800,2093,173,21636,5828,5299,2841,46975,8140,24436,7921,5472,31.86%,10.33%,7%,3816,70372,4.97%,95.03%,56186,10247,140,568,10,249,
0500000US17185,"Wabash County, Illinois",11390,5780,50.75%,49.25%,55.3,371,3.26%,176,406,117,2514,1469,1010,530,7449,1540,2690,1875,1127,23.62%,16.46%,10%,178,11183,1.56%,98.44%,10520,53,15,251,6,15,
0500000US17187,"Warren County, Illinois",16981,8738,51.46%,48.54%,50.2,858,5.05%,511,1327,163,3705,889,1760,758,9776,2518,4216,2216,1923,24.83%,13.05%,11%,1789,15046,10.54%,89.46%,13494,577,31,329,15,46,
0500000US17189,"Washington County, Illinois",13967,7035,50.37%,49.63%,59.3,513,3.67%,375,403,54,3223,1620,1404,714,9266,2118,3598,2023,1458,25.76%,14.48%,10%,224,13537,1.60%,98.40%,12976,85,25,65,20,15,
0500000US17191,"Wayne County, Illinois",16309,8251,50.59%,49.41%,57.9,703,4.31%,270,516,60,4024,1921,1170,469,10083,1639,4294,2437,1230,26.33%,14.94%,8%,182,15997,1.12%,98.88%,15400,90,26,49,5,29,
0500000US17193,"White County, Illinois",13712,6988,50.96%,49.04%,52.9,689,5.02%,280,417,66,3430,1555,1174,520,8985,1694,3710,1972,1240,27.06%,14.38%,9%,188,13689,1.37%,98.63%,13007,91,22,65,18,15,
0500000US17195,"Whiteside County, Illinois",55583,27795,50.01%,49.99%,51.7,1972,3.55%,1814,1460,271,14707,4018,4736,2656,35723,7392,16521,5478,5007,29.72%,9.86%,9%,7131,48560,12.83%,87.17%,45341,741,60,306,9,149,
0500000US17197,"Will County, Illinois",689704,347565,50.39%,49.61%,53.8,21760,3.15%,22939,25287,8191,119799,39063,101412,57014,416344,158426,142738,64350,109603,20.70%,9.33%,16%,130851,565504,18.97%,81.03%,418418,79256,711,42416,82,2105,
0500000US17199,"Williamson County, Illinois",66929,33583,50.18%,49.82%,48.9,4013,6.00%,1774,2016,306,14245,5121,7388,4833,44118,12221,16019,7137,7694,23.93%,10.66%,11%,1779,65374,2.66%,97.34%,58193,2809,230,771,9,207,
0500000US17201,"Winnebago County, Illinois",283635,145155,51.18%,48.82%,47.4,20297,7.16%,8691,8409,2026,59645,18364,28745,15765,170036,44510,68336,26773,30771,24.09%,9.44%,11%,40952,244398,14.44%,85.56%,183235,38240,559,7938,66,1099,
0500000US17203,"Woodford County, Illinois",38503,19287,50.09%,49.91%,59.6,806,2.09%,1082,1581,386,7895,2835,5620,3180,24591,8800,8977,4416,6006,23.32%,11.47%,16%,740,37727,1.92%,98.08%,35844,269,42,217,10,89,
0500000US18001,"Adams County, Indiana",35544,17800,50.08%,49.92%,54.9,2264,6.37%,1165,757,224,8976,2105,2225,961,18114,3186,10141,2862,2449,28.53%,8.05%,7%,1637,34172,4.61%,95.39%,33080,171,80,135,4,50,
0500000US18003,"Allen County, Indiana",375520,191922,51.11%,48.89%,48.5,18886,5.03%,12017,13357,3185,70137,26707,47685,23196,220289,70881,82154,40064,50870,21.88%,10.67%,14%,32923,352487,8.77%,91.23%,270149,43629,883,18191,138,1940,
0500000US18005,"Bartholomew County, Indiana",83280,41538,49.88%,50.12%,51.6,5323,6.39%,2626,1692,1189,17621,4909,11004,8248,51063,19252,20247,6601,12193,24.31%,7.93%,15%,7257,74951,8.71%,91.29%,64395,1768,132,5383,45,290,
0500000US18007,"Benton County, Indiana",8695,4363,50.18%,49.82%,48.9,540,6.21%,219,231,23,2311,461,832,245,5243,1077,2530,692,855,29.10%,7.96%,10%,629,8090,7.23%,92.77%,7789,44,15,13,7,28,
0500000US18009,"Blackford County, Indiana",11926,6083,51.01%,48.99%,55.4,1143,9.58%,348,261,97,4003,740,658,499,7694,1157,4351,1001,755,36.48%,8.39%,6%,252,11860,2.11%,97.89%,11278,54,38,24,0,30,
0500000US18011,"Boone County, Indiana",66875,33740,50.45%,49.55%,63.1,2218,3.32%,1424,1517,1315,8242,3709,13681,8835,41900,22516,9666,5226,14996,14.45%,7.81%,22%,2775,68037,4.15%,95.85%,61135,1426,128,2389,19,241,
0500000US18013,"Brown County, Indiana",15093,7631,50.56%,49.44%,67.7,569,3.77%,344,374,20,3798,941,2059,1315,10735,3374,4142,1315,2079,27.44%,8.71%,14%,270,15205,1.79%,98.21%,14463,55,30,65,5,48,
0500000US18015,"Carroll County, Indiana",20137,9990,49.61%,50.39%,56,725,3.60%,750,464,38,5798,1421,1520,650,12438,2170,6548,1885,1558,32.52%,9.36%,8%,823,19483,4.09%,95.91%,18727,128,33,48,0,57,
0500000US18017,"Cass County, Indiana",37727,18949,50.23%,49.77%,48.5,2093,5.55%,1076,1048,218,10583,2709,2310,1061,22114,3371,11659,3757,2528,30.90%,9.96%,7%,6675,31195,17.69%,82.31%,28744,560,109,573,8,76,
0500000US18019,"Clark County, Indiana",117410,60319,51.38%,48.63%,49.2,4434,3.78%,3732,3804,710,28998,8533,11224,5649,73468,16873,32730,12337,11934,27.88%,10.51%,10%,7891,113202,6.72%,93.28%,95403,9265,249,1305,127,491,
0500000US18021,"Clay County, Indiana",26231,13364,50.95%,49.05%,56.2,1033,3.94%,591,747,48,7692,2320,2145,870,16544,3015,8283,3067,2193,31.58%,11.69%,8%,460,26006,1.75%,98.25%,24880,129,43,91,6,47,
0500000US18023,"Clinton County, Indiana",32186,16200,50.33%,49.67%,51.2,1251,3.89%,1031,838,162,9534,1929,2065,1037,18386,3102,10565,2767,2227,32.82%,8.60%,7%,6142,27048,19.08%,80.92%,25808,196,62,70,13,46,
0500000US18025,"Crawford County, Indiana",10582,5191,49.06%,50.95%,51.2,1166,11.02%,367,194,25,3513,515,476,302,6157,778,3880,709,501,36.67%,6.70%,5%,121,10405,1.14%,98.86%,9989,26,23,17,1,8,
0500000US18027,"Daviess County, Indiana",33277,16526,49.66%,50.34%,54,1790,5.38%,792,713,58,7349,2378,1776,869,15691,2645,8141,3091,1834,24.46%,9.29%,6%,2103,31278,6.32%,93.68%,29708,619,38,132,8,76,
0500000US18029,"Dearborn County, Indiana",49612,24969,50.33%,49.67%,54.6,1940,3.91%,1647,1224,424,13042,3033,5824,3056,31179,8880,14689,4257,6248,29.61%,8.58%,13%,724,49955,1.46%,98.54%,47319,292,66,211,9,162,
0500000US18031,"Decatur County, Indiana",26587,13340,50.18%,49.83%,53.5,1379,5.19%,805,704,441,8154,1599,2354,1141,16399,3495,8959,2303,2795,33.70%,8.66%,11%,614,25858,2.31%,97.69%,24769,90,35,154,8,39,
0500000US18033,"DeKalb County, Indiana",43193,21630,50.08%,49.92%,54.5,2528,5.85%,1508,786,283,12839,2713,3866,1396,26607,5262,14347,3499,4149,33.22%,8.10%,10%,1185,42080,2.74%,97.26%,40232,183,67,225,39,79,
0500000US18035,"Delaware County, Indiana",114461,59228,51.75%,48.26%,40.4,12367,10.80%,5017,14041,2114,24388,6761,10044,7646,64128,17690,29405,20802,12158,25.69%,18.17%,11%,3533,108370,3.09%,96.91%,93333,8141,218,1388,58,417,
0500000US18037,"Dubois County, Indiana",42534,21376,50.26%,49.74%,53.8,1847,4.34%,1164,1353,242,10877,3336,5412,1963,25808,7375,12041,4689,5654,28.31%,11.02%,13%,4146,39491,9.75%,90.25%,38137,190,55,247,5,89,
0500000US18039,"Elkhart County, Indiana",205184,103730,50.56%,49.45%,51.2,11093,5.41%,6860,5323,1510,45052,9355,16952,8527,105749,25479,51912,14678,18462,25.30%,7.15%,9%,39594,167453,19.30%,80.70%,145039,11051,373,2236,54,716,
0500000US18041,"Fayette County, Indiana",23068,11778,51.06%,48.94%,52.3,1876,8.13%,734,619,155,7181,1190,1692,694,13475,2386,7915,1809,1847,34.31%,7.84%,8%,273,23125,1.18%,98.82%,22014,275,32,58,2,48,
0500000US18043,"Floyd County, Indiana",77879,40177,51.59%,48.41%,49.1,3177,4.08%,2145,2507,730,16293,4997,10405,5801,48916,16206,18438,7504,11135,23.68%,9.64%,14%,3082,77402,3.96%,96.04%,67970,4276,169,973,21,246,
0500000US18045,"Fountain County, Indiana",16456,8228,50.00%,50.00%,54.7,701,4.26%,586,426,57,5129,1020,1068,551,10265,1619,5715,1446,1125,34.73%,8.79%,7%,412,16067,2.50%,97.50%,15349,56,38,43,6,23,
0500000US18047,"Franklin County, Indiana",22750,11473,50.43%,49.57%,57,899,3.95%,662,577,182,6405,1311,2074,1112,13824,3186,7067,1888,2256,31.06%,8.30%,10%,219,22566,0.96%,99.04%,21790,23,25,91,1,32,
0500000US18049,"Fulton County, Indiana",20069,10146,50.56%,49.44%,49,1259,6.27%,410,813,58,5512,1070,1299,711,12017,2010,5922,1883,1357,29.51%,9.38%,7%,1068,19412,5.32%,94.68%,18452,141,64,76,0,43,
0500000US18051,"Gibson County, Indiana",33711,16728,49.62%,50.38%,56.6,1139,3.38%,1041,1191,95,9442,2679,2986,1272,21131,4258,10483,3870,3081,31.10%,11.48%,9%,680,32331,2.02%,97.98%,30159,637,61,214,16,115,
0500000US18053,"Grant County, Indiana",66055,34585,52.36%,47.64%,46,4841,7.33%,2655,4474,453,16884,4131,4685,3333,38654,8018,19539,8605,5138,29.58%,13.03%,8%,3412,63262,5.17%,94.83%,54500,4566,157,524,22,240,
0500000US18055,"Greene County, Indiana",32174,16119,50.10%,49.90%,54.8,1429,4.44%,1051,744,126,9202,2611,2279,1107,20128,3386,10253,3355,2405,31.87%,10.43%,7%,551,30252,1.71%,98.29%,29035,53,68,104,4,51,
0500000US18057,"Hamilton County, Indiana",330455,168977,51.14%,48.87%,61.8,7519,2.28%,7436,8449,5769,32104,15570,79029,49195,209780,128224,39540,24019,84798,11.97%,7.27%,26%,18106,329361,5.48%,94.52%,275185,14674,402,23459,134,1483,
0500000US18059,"Hancock County, Indiana",76614,38524,50.28%,49.72%,59.8,2300,3.00%,2199,1975,388,16475,4847,11198,5647,49286,16845,18674,6822,11586,24.37%,8.90%,15%,2202,77638,2.87%,97.13%,71106,2346,121,734,42,219,
0500000US18061,"Harrison County, Indiana",40164,20159,50.19%,49.81%,53.2,1583,3.94%,1148,1191,136,11809,2441,3259,1962,25465,5221,12957,3632,3395,32.26%,9.04%,8%,928,38726,2.31%,97.69%,36702,185,92,189,17,107,
0500000US18063,"Hendricks County, Indiana",166806,83444,50.03%,49.98%,57.6,2777,1.66%,4390,5340,1417,29937,9738,27770,15507,104957,43277,34327,15078,29187,20.58%,9.04%,17%,8056,166732,4.83%,95.17%,139374,13350,264,5667,66,729,
0500000US18065,"Henry County, Indiana",48158,22864,47.48%,52.52%,48,2532,5.26%,1637,1425,183,15030,3100,3691,1930,30990,5621,16667,4525,3874,34.61%,9.40%,8%,977,47937,2.03%,97.97%,45105,1066,67,197,5,106,
0500000US18067,"Howard County, Indiana",82486,42698,51.76%,48.24%,49.5,3732,4.52%,2693,2304,529,21429,5174,7791,4282,51951,12073,24122,7478,8320,29.24%,9.07%,10%,3060,80598,3.71%,96.29%,68470,6416,209,1027,19,306,
0500000US18069,"Huntington County, Indiana",36351,18377,50.55%,49.45%,51.1,1279,3.52%,1444,1157,313,10431,2360,3415,1839,22990,5254,11875,3517,3728,32.67%,9.68%,10%,1050,35612,2.89%,97.11%,33874,221,140,163,7,83,
0500000US18071,"Jackson County, Indiana",44077,22235,50.45%,49.55%,53,2050,4.65%,1512,895,145,12175,2495,3615,1754,26678,5369,13687,3390,3760,31.05%,7.69%,9%,6251,40177,14.18%,85.82%,37815,485,68,469,5,94,
0500000US18073,"Jasper County, Indiana",33433,16699,49.95%,50.05%,51.7,1596,4.77%,1134,1147,193,10116,2008,2325,1107,20302,3432,11250,3155,2518,33.65%,9.44%,8%,2342,30576,7.01%,92.99%,29084,129,53,90,10,43,
0500000US18075,"Jay County, Indiana",20697,10318,49.85%,50.15%,49.5,1585,7.66%,795,336,145,6524,1263,1146,584,12175,1730,7319,1599,1291,35.36%,7.73%,6%,944,19534,4.56%,95.44%,18892,53,24,64,12,26,
0500000US18077,"Jefferson County, Indiana",32167,16813,52.27%,47.73%,46.5,1941,6.03%,1032,1597,219,9318,2414,2540,1349,20026,3889,10350,4011,2759,32.18%,12.47%,9%,1111,32036,3.45%,96.55%,30023,510,79,290,10,106,
0500000US18079,"Jennings County, Indiana",27639,13656,49.41%,50.59%,51.8,1167,4.22%,1277,681,143,8502,1332,1725,688,16706,2413,9779,2013,1868,35.38%,7.28%,7%,859,26754,3.11%,96.89%,25665,175,39,49,2,44,
0500000US18081,"Johnson County, Indiana",156148,79344,50.81%,49.19%,54.8,5043,3.23%,4944,4852,1649,32443,8846,21997,11698,95840,33695,37387,13698,23646,23.94%,8.77%,15%,6394,155371,4.09%,95.91%,136748,3850,280,7420,69,623,
0500000US18083,"Knox County, Indiana",36833,18194,49.40%,50.60%,48.9,2252,6.11%,1302,2622,153,8898,3721,2468,1580,21702,4048,10200,6343,2621,27.69%,17.22%,7%,1005,35277,2.73%,97.27%,33027,696,67,283,13,104,
0500000US18085,"Kosciusko County, Indiana",79156,39630,50.07%,49.93%,53.7,2985,3.77%,2763,2524,511,18069,4028,8129,4753,45931,12882,20832,6552,8640,26.32%,8.28%,11%,7492,72748,9.46%,90.54%,67990,682,160,1336,16,205,
0500000US18087,"LaGrange County, Indiana",39537,19531,49.40%,50.60%,59,1129,2.86%,723,511,57,6954,1249,1756,914,14124,2670,7677,1760,1813,19.42%,4.45%,5%,1733,38713,4.38%,95.62%,37834,92,50,74,1,33,
0500000US18089,"Lake County, Indiana",485983,250786,51.60%,48.40%,45,35807,7.37%,16619,15505,3452,116972,27952,50222,25844,293609,76066,133591,43457,53674,27.49%,8.94%,11%,99927,398773,20.56%,79.44%,251106,121048,691,7334,95,1682,
0500000US18091,"LaPorte County, Indiana",110026,53353,48.49%,51.51%,46.8,7251,6.59%,3956,2351,916,30479,7056,10057,4704,69014,14761,34435,9407,10973,31.30%,8.55%,10%,7985,104432,7.26%,92.74%,85957,11874,250,743,18,467,
0500000US18093,"Lawrence County, Indiana",45552,23167,50.86%,49.14%,55.3,2360,5.18%,1363,1394,150,13297,3339,3639,2411,28689,6050,14660,4733,3789,32.18%,10.39%,8%,765,44246,1.68%,98.32%,42224,191,131,207,4,93,
0500000US18095,"Madison County, Indiana",129486,64738,50.00%,50.00%,46.3,7557,5.84%,4955,3382,773,36173,8300,10863,5613,80474,16476,41128,11682,11636,31.76%,9.02%,9%,6263,123866,4.84%,95.16%,106928,10116,259,649,42,483,
0500000US18097,"Marion County, Indiana",957337,496234,51.84%,48.17%,39.2,76394,7.98%,30828,31730,13066,173864,48854,131401,71428,547308,202829,204692,80584,144467,21.38%,8.42%,15%,129286,847917,13.50%,86.50%,493665,265659,1752,39827,374,5373,
0500000US18099,"Marshall County, Indiana",46336,23183,50.03%,49.97%,54.8,2397,5.17%,1409,1150,223,11882,2378,3860,2245,26352,6105,13291,3528,4083,28.68%,7.61%,9%,5251,40844,11.33%,88.67%,38910,204,63,274,7,112,
0500000US18101,"Martin County, Indiana",10169,5016,49.33%,50.67%,47.8,267,2.63%,241,388,74,3083,997,621,280,6230,901,3324,1385,695,32.69%,13.62%,7%,92,9720,0.90%,99.10%,9335,20,20,33,6,11,
0500000US18103,"Miami County, Indiana",35684,16887,47.32%,52.68%,50.4,2463,6.90%,1625,841,212,10316,2145,2278,1139,21416,3417,11941,2986,2490,33.46%,8.37%,7%,1186,34776,3.32%,96.68%,31123,1792,281,130,4,102,
0500000US18105,"Monroe County, Indiana",147318,74105,50.30%,49.70%,36.9,17218,11.69%,6295,25742,5556,18818,6847,19959,18739,79483,38698,25113,32589,25515,17.05%,22.12%,17%,6358,133360,4.32%,95.68%,112490,5016,222,8350,37,538,
0500000US18107,"Montgomery County, Indiana",38295,18941,49.46%,50.54%,53.8,1600,4.18%,1434,1434,118,10630,1919,3508,1941,23710,5449,12064,3353,3626,31.50%,8.76%,9%,2281,35655,5.96%,94.04%,33748,343,73,236,13,77,
0500000US18109,"Morgan County, Indiana",70141,35368,50.42%,49.58%,55.9,2799,3.99%,2008,1708,489,19565,4060,5964,3088,42840,9052,21573,5768,6453,30.76%,8.22%,9%,1274,70506,1.82%,98.18%,66972,339,195,276,11,178,
0500000US18111,"Newton County, Indiana",13981,6935,49.60%,50.40%,51.7,951,6.80%,394,251,53,4506,756,953,237,8571,1190,4900,1007,1006,35.05%,7.20%,7%,1039,12791,7.43%,92.57%,12053,42,25,34,2,34,
0500000US18113,"Noble County, Indiana",47640,23690,49.73%,50.27%,53.5,1450,3.04%,1749,1081,269,12740,2716,3485,1434,26757,4919,14489,3797,3754,30.41%,7.97%,8%,5250,42207,11.02%,88.98%,40235,217,71,223,1,104,
0500000US18115,"Ohio County, Indiana",5890,2962,50.29%,49.71%,59.4,258,4.38%,173,135,18,1829,341,412,222,3863,634,2002,476,430,33.99%,8.08%,7%,79,5861,1.34%,98.66%,5629,16,4,29,0,16,
0500000US18117,"Orange County, Indiana",19552,9735,49.79%,50.21%,50,680,3.48%,593,489,118,6003,1111,1154,611,11401,1765,6596,1600,1272,33.74%,8.18%,7%,305,19562,1.56%,98.44%,18527,200,37,60,11,34,
0500000US18119,"Owen County, Indiana",20854,10107,48.47%,51.53%,53.3,1007,4.83%,645,374,155,6404,1014,1472,733,12832,2205,7049,1388,1627,33.80%,6.66%,8%,297,21024,1.42%,98.58%,19874,79,47,62,0,50,
0500000US18121,"Parke County, Indiana",16912,8931,52.81%,47.19%,56.3,1009,5.97%,372,371,75,4620,1273,884,600,9974,1484,4992,1644,959,29.52%,9.72%,6%,225,15931,1.33%,98.67%,15329,198,55,30,0,12,
0500000US18123,"Perry County, Indiana",19091,8912,46.68%,53.32%,51.5,847,4.44%,569,571,73,6276,1272,1418,761,12330,2179,6845,1843,1491,35.85%,9.65%,8%,220,18950,1.15%,98.85%,17853,397,33,99,3,46,
0500000US18125,"Pike County, Indiana",12364,6260,50.63%,49.37%,55.9,315,2.55%,450,155,162,3914,822,905,446,7661,1351,4364,977,1067,35.30%,7.90%,9%,180,12070,1.46%,98.54%,11666,31,39,15,0,11,
0500000US18127,"Porter County, Indiana",169482,85716,50.58%,49.43%,51.5,7511,4.43%,6451,5403,1475,40127,10478,20970,12531,109352,33501,46578,15881,22445,27.48%,9.37%,13%,18904,154311,11.15%,88.85%,136993,7246,259,2197,51,602,
0500000US18129,"Posey County, Indiana",25480,12791,50.20%,49.80%,61.1,1003,3.94%,574,778,200,6584,1975,2694,1449,16663,4143,7158,2753,2894,28.09%,10.80%,11%,375,24847,1.47%,98.53%,23640,211,44,107,3,57,
0500000US18131,"Pulaski County, Indiana",12482,6221,49.84%,50.16%,49.5,657,5.26%,524,343,51,3815,722,758,361,7647,1119,4339,1065,809,34.76%,8.53%,6%,458,12056,3.67%,96.33%,11442,65,24,44,3,14,
0500000US18133,"Putnam County, Indiana",37419,17776,47.51%,52.50%,51.5,1475,3.94%,1341,3352,175,10448,2127,2705,1516,22239,4221,11789,5479,2880,31.51%,14.64%,8%,784,35942,2.10%,97.90%,33150,1024,70,355,14,126,
0500000US18135,"Randolph County, Indiana",24694,12559,50.86%,49.14%,53.8,1262,5.11%,852,564,66,7226,1220,1694,1123,15253,2817,8078,1784,1760,32.71%,7.22%,7%,1156,23346,4.68%,95.32%,22325,119,52,67,0,60,
0500000US18137,"Ripley County, Indiana",28457,14406,50.62%,49.38%,57.7,1556,5.47%,1262,502,148,8110,1943,2209,1576,17435,3785,9372,2445,2357,32.93%,8.59%,8%,541,28454,1.90%,98.10%,27213,73,45,183,0,53,
0500000US18139,"Rush County, Indiana",16632,8440,50.75%,49.25%,53.4,1027,6.17%,636,381,18,5369,872,1229,538,10235,1767,6005,1253,1247,36.11%,7.53%,7%,252,16500,1.52%,98.48%,15876,90,19,54,3,36,
0500000US18141,"St. Joseph County, Indiana",270881,139002,51.32%,48.69%,44.8,18514,6.83%,9455,14271,3646,53055,15591,32679,22184,159026,54863,62510,29862,36325,23.08%,11.02%,13%,26576,246336,9.81%,90.19%,188556,35420,773,6586,159,1350,
0500000US18143,"Scott County, Indiana",23785,12073,50.76%,49.24%,46.7,1159,4.87%,1004,581,98,6955,1112,1300,876,13325,2176,7959,1693,1398,33.46%,7.12%,6%,535,23849,2.25%,97.75%,22829,92,27,87,11,44,
0500000US18145,"Shelby County, Indiana",44559,22611,50.74%,49.26%,54.3,1930,4.33%,1498,1063,179,13475,2424,4064,1820,27378,5884,14973,3487,4243,33.60%,7.83%,10%,2377,42678,5.33%,94.67%,40305,537,60,339,3,127,
0500000US18147,"Spencer County, Indiana",20364,10110,49.65%,50.35%,57.8,555,2.73%,477,574,111,6181,1799,1617,890,13173,2507,6658,2373,1728,32.69%,11.65%,8%,676,19134,3.32%,96.68%,18368,129,44,73,1,28,
0500000US18149,"Starke County, Indiana",22996,11547,50.21%,49.79%,49.8,2073,9.01%,681,578,62,6910,1264,1274,558,13455,1832,7591,1842,1336,33.01%,8.01%,6%,902,22469,3.92%,96.08%,21395,67,60,40,4,41,
0500000US18151,"Steuben County, Indiana",34591,16924,48.93%,51.07%,55.7,1456,4.21%,1244,1341,286,9415,2427,3304,2077,21892,5381,10659,3768,3590,30.81%,10.89%,10%,1427,33008,4.13%,95.87%,31438,234,64,187,2,94,
0500000US18153,"Sullivan County, Indiana",20647,9705,47.00%,53.00%,49.5,885,4.29%,626,604,146,6471,1762,1197,698,13201,1895,7097,2366,1343,34.37%,11.46%,7%,334,20483,1.62%,98.38%,18856,877,43,33,8,28,
0500000US18155,"Switzerland County, Indiana",10727,5189,48.37%,51.63%,48.8,868,8.09%,516,105,13,3789,429,446,241,6146,687,4305,534,459,40.13%,4.98%,4%,114,9623,1.06%,98.94%,9262,14,26,20,0,11,
0500000US18157,"Tippecanoe County, Indiana",193302,94533,48.90%,51.10%,40.4,18588,9.62%,12422,25908,6345,29223,7805,23755,18912,98921,42667,41645,33713,30100,21.54%,17.44%,16%,18647,167604,9.65%,90.35%,131465,11080,346,13613,38,791,
0500000US18159,"Tipton County, Indiana",15154,7694,50.77%,49.23%,62.3,341,2.25%,350,448,147,4331,953,1919,894,9857,2813,4681,1401,2066,30.89%,9.25%,14%,434,14925,2.86%,97.14%,14367,46,13,46,2,56,
0500000US18161,"Union County, Indiana",7140,3636,50.92%,49.08%,60,104,1.46%,287,127,62,2077,418,653,325,4476,978,2364,545,715,33.11%,7.63%,10%,74,7013,1.04%,98.96%,6765,21,22,33,8,12,
0500000US18163,"Vanderburgh County, Indiana",181548,93442,51.47%,48.53%,45.2,12288,6.77%,5100,8486,1918,39263,13520,21681,11832,112437,33513,44363,22006,23599,24.44%,12.12%,13%,6313,173823,3.48%,96.52%,143444,17459,331,2411,677,709,
0500000US18165,"Vermillion County, Indiana",15485,7751,50.06%,49.95%,57.4,1323,8.54%,411,481,40,4643,1295,1183,530,10008,1713,5054,1776,1223,32.64%,11.47%,8%,168,15271,1.08%,98.92%,14692,37,27,46,11,18,
0500000US18167,"Vigo County, Indiana",107305,52846,49.25%,50.75%,41.4,9422,8.78%,4180,9093,1441,22573,6128,10134,7134,62179,17268,26753,15221,11575,24.93%,14.18%,11%,3239,102914,3.02%,96.98%,88137,7079,311,2003,25,616,
0500000US18169,"Wabash County, Indiana",31198,15935,51.08%,48.92%,53.2,1613,5.17%,1217,1327,206,9213,1820,2522,1535,19249,4057,10430,3147,2728,33.43%,10.09%,9%,897,30079,2.88%,97.12%,28634,158,126,161,9,66,
0500000US18171,"Warren County, Indiana",8219,4096,49.84%,50.16%,63.5,536,6.52%,175,236,66,2426,748,787,306,5505,1093,2601,984,853,31.65%,11.97%,10%,193,8247,2.35%,97.65%,8018,7,7,26,0,11,
0500000US18173,"Warrick County, Indiana",62608,32048,51.19%,48.81%,62.7,1577,2.52%,1615,1787,431,12330,5207,9089,5159,40670,14248,13945,6994,9520,22.27%,11.17%,15%,1383,62515,2.21%,97.79%,57346,1038,92,1639,11,183,
0500000US18175,"Washington County, Indiana",27942,14147,50.63%,49.37%,54.2,1252,4.48%,829,740,134,8282,1911,1771,635,16571,2406,9111,2651,1905,32.61%,9.49%,7%,400,27782,1.43%,98.57%,26600,113,66,95,10,67,
0500000US18177,"Wayne County, Indiana",66176,34043,51.44%,48.56%,47.7,4854,7.33%,2600,2529,253,16554,4360,5462,3541,39888,9003,19154,6889,5715,28.94%,10.41%,9%,2495,64058,3.77%,96.23%,56689,3027,142,707,12,330,
0500000US18179,"Wells County, Indiana",28010,14285,51.00%,49.00%,59.9,750,2.68%,984,595,150,7671,2397,2570,990,17547,3560,8655,2992,2720,30.90%,10.68%,10%,1019,27161,3.64%,96.36%,26000,220,50,130,5,40,
0500000US18181,"White County, Indiana",24163,12071,49.96%,50.04%,54.8,1084,4.49%,817,527,54,6736,1638,1909,877,14918,2786,7553,2165,1963,31.26%,8.96%,8%,2453,22235,10.15%,89.85%,21203,111,50,94,6,29,
0500000US18183,"Whitley County, Indiana",33899,17050,50.30%,49.70%,57.5,1363,4.02%,1021,775,218,8604,2808,3817,1473,21576,5290,9625,3583,4035,28.39%,10.57%,12%,841,33350,2.48%,97.52%,31832,150,91,173,3,78,
0500000US19001,"Adair County, Iowa",7048,3538,50.20%,49.80%,57.7,326,4.63%,203,171,23,2075,757,748,247,4848,995,2278,928,771,32.32%,13.17%,11%,186,7310,2.64%,97.36%,7066,45,16,23,1,4,
0500000US19003,"Adams County, Iowa",3633,1842,50.70%,49.30%,58.8,268,7.38%,112,95,2,1027,415,357,102,2473,459,1139,510,359,31.35%,14.04%,10%,42,3662,1.16%,98.84%,3518,12,15,13,0,15,
0500000US19005,"Allamakee County, Iowa",13761,6824,49.59%,50.41%,57.3,718,5.22%,320,478,19,3705,1348,1280,475,8526,1755,4025,1826,1299,29.25%,13.27%,9%,1221,12840,8.87%,91.13%,12401,146,14,41,5,24,
0500000US19007,"Appanoose County, Iowa",12462,6372,51.13%,48.87%,51.8,1270,10.19%,365,261,42,3094,1065,1256,373,8009,1629,3459,1326,1298,27.76%,10.64%,10%,231,12086,1.85%,98.15%,11586,75,19,69,0,14,
0500000US19009,"Audubon County, Iowa",5528,2784,50.36%,49.64%,59.7,220,3.98%,130,170,50,1412,486,555,199,3610,754,1542,656,605,27.89%,11.87%,11%,86,5588,1.56%,98.44%,5443,17,5,4,1,4,
0500000US19011,"Benton County, Iowa",25558,12798,50.07%,49.93%,58.7,886,3.47%,618,828,94,6797,2613,2522,1109,16828,3631,7415,3441,2616,29.01%,13.46%,10%,462,25113,1.81%,98.19%,24077,112,29,79,2,57,
0500000US19013,"Black Hawk County, Iowa",131813,67098,50.90%,49.10%,46,9682,7.35%,3773,12414,1917,25040,9666,16215,8247,76903,24462,28813,22080,18132,21.86%,16.75%,14%,6448,124696,4.89%,95.11%,101150,13529,219,3412,848,377,
0500000US19015,"Boone County, Iowa",26381,13174,49.94%,50.06%,55.3,910,3.45%,963,803,169,6058,2726,3366,1379,17565,4745,7021,3529,3535,26.61%,13.38%,13%,709,26006,2.69%,97.31%,24720,289,51,100,3,42,
0500000US19017,"Bremer County, Iowa",25032,12625,50.44%,49.57%,55.9,836,3.34%,336,2155,250,5127,2401,3715,1736,15916,5451,5463,4556,3965,21.82%,18.20%,16%,511,24477,2.04%,97.96%,23403,239,26,196,2,32,
0500000US19019,"Buchanan County, Iowa",21141,10665,50.45%,49.55%,57.5,736,3.48%,636,457,131,5102,1931,2205,896,13187,3101,5738,2388,2336,27.14%,11.30%,11%,338,20227,1.60%,98.40%,19565,70,18,52,11,17,
0500000US19021,"Buena Vista County, Iowa",19950,10047,50.36%,49.64%,51.4,647,3.24%,454,1335,215,3752,1216,1798,795,9706,2593,4206,2551,2013,21.08%,12.79%,10%,5925,14898,29.70%,70.30%,11377,560,29,1889,614,77,
0500000US19023,"Butler County, Iowa",14508,7278,50.17%,49.84%,60.6,648,4.47%,333,425,93,3806,1522,1440,427,9617,1867,4139,1947,1533,28.53%,13.42%,11%,183,14151,1.26%,98.74%,13751,26,16,28,0,19,
0500000US19025,"Calhoun County, Iowa",9656,4657,48.23%,51.77%,55.9,525,5.44%,139,364,80,2640,959,905,462,6517,1367,2779,1323,985,28.78%,13.70%,10%,236,9691,2.44%,97.56%,9261,151,22,24,8,19,
0500000US19027,"Carroll County, Iowa",20150,10115,50.20%,49.80%,55.5,516,2.56%,774,624,119,4553,1850,2498,729,12853,3227,5327,2474,2617,26.44%,12.28%,13%,594,20166,2.95%,97.05%,19409,262,19,75,0,18,
0500000US19029,"Cass County, Iowa",12990,6544,50.38%,49.62%,57.7,526,4.05%,304,297,8,3013,885,1506,636,8277,2142,3317,1182,1514,25.54%,9.10%,12%,306,12821,2.36%,97.64%,12317,28,17,35,78,28,
0500000US19031,"Cedar County, Iowa",18475,9381,50.78%,49.22%,57.6,482,2.61%,575,473,128,5149,1664,2039,712,12470,2751,5724,2137,2167,30.98%,11.57%,12%,462,18043,2.50%,97.50%,17334,79,40,61,2,54,
0500000US19033,"Cerro Gordo County, Iowa",42672,21857,51.22%,48.78%,53.4,1526,3.58%,1109,1699,196,10261,4745,4779,2305,28457,7084,11370,6444,4975,26.65%,15.10%,12%,2243,40884,5.26%,94.74%,37819,848,96,535,137,82,
0500000US19035,"Cherokee County, Iowa",11281,5608,49.71%,50.29%,56.8,698,6.19%,119,489,13,2962,910,1240,620,7564,1860,3081,1399,1253,27.31%,12.40%,11%,530,11128,4.70%,95.30%,10668,84,24,57,14,28,
0500000US19037,"Chickasaw County, Iowa",11970,5899,49.28%,50.72%,61.9,278,2.32%,325,412,77,3670,1196,1025,437,7689,1462,3995,1608,1102,33.38%,13.43%,9%,481,11531,4.02%,95.98%,11173,75,7,28,0,7,
0500000US19039,"Clarke County, Iowa",9383,4669,49.76%,50.24%,55.2,1164,12.41%,232,330,45,2582,595,746,273,5479,1019,2814,925,791,29.99%,9.86%,8%,1534,8214,16.35%,83.65%,7837,43,7,81,40,28,
0500000US19041,"Clay County, Iowa",16138,8210,50.87%,49.13%,53.8,471,2.92%,454,341,256,3678,1399,1896,786,10620,2682,4132,1740,2152,25.60%,10.78%,13%,704,15680,4.36%,95.64%,15025,99,37,105,2,12,
0500000US19043,"Clayton County, Iowa",17527,8674,49.49%,50.51%,55.7,644,3.67%,524,420,58,5657,1331,1621,542,11435,2163,6181,1751,1679,35.27%,9.99%,10%,343,16700,1.96%,98.04%,16111,158,34,47,6,16,
0500000US19045,"Clinton County, Iowa",46734,23880,51.10%,48.90%,49,2485,5.32%,1214,1664,235,12158,3771,4541,1768,29571,6309,13372,5435,4776,28.61%,11.63%,10%,1539,44921,3.29%,96.71%,41226,1392,103,252,10,104,
0500000US19047,"Crawford County, Iowa",16998,8512,50.08%,49.92%,53.6,1738,10.22%,512,926,121,4264,928,1198,460,8960,1658,4776,1854,1319,28.10%,10.91%,8%,4912,11613,28.90%,71.10%,10625,383,31,303,4,27,
0500000US19049,"Dallas County, Iowa",90418,45761,50.61%,49.39%,59.5,1334,1.48%,1811,1886,1827,10862,6152,20343,9519,56536,29862,12673,8038,22170,14.02%,8.89%,25%,6515,93163,7.21%,92.79%,81708,2657,137,4987,32,340,
0500000US19051,"Davis County, Iowa",8977,4499,50.12%,49.88%,62.7,134,1.49%,68,160,20,1749,783,795,253,4612,1048,1817,943,815,20.24%,10.50%,9%,144,8966,1.60%,98.40%,8735,8,11,15,0,10,
0500000US19053,"Decatur County, Iowa",7908,3933,49.73%,50.27%,53.7,595,7.52%,218,934,71,1830,370,702,580,4342,1282,2048,1304,773,25.90%,16.49%,10%,211,7434,2.67%,97.33%,7010,97,17,39,21,26,
0500000US19055,"Delaware County, Iowa",17107,8420,49.22%,50.78%,62.1,636,3.72%,461,454,140,5066,1445,1427,626,10708,2053,5527,1899,1567,32.31%,11.10%,9%,244,17244,1.43%,98.57%,16706,122,24,39,0,30,
0500000US19057,"Des Moines County, Iowa",39227,20224,51.56%,48.44%,47.6,2444,6.23%,1210,1201,193,9088,3973,3632,1804,25275,5436,10298,5174,3825,26.25%,13.19%,10%,1245,37665,3.17%,96.83%,32753,2501,67,398,21,128,
0500000US19059,"Dickinson County, Iowa",17260,8681,50.30%,49.71%,57.1,347,2.01%,289,593,113,3381,1812,3061,1077,12318,4138,3670,2405,3174,21.26%,13.93%,18%,406,17297,2.35%,97.65%,16709,76,14,80,1,25,
0500000US19061,"Dubuque County, Iowa",97193,49243,50.67%,49.34%,53.3,4479,4.61%,2504,4954,1340,21321,6513,13116,7339,60811,20455,23825,11467,14456,24.51%,11.80%,15%,2977,96289,3.06%,96.94%,87349,4035,131,1018,813,255,
0500000US19063,"Emmet County, Iowa",9322,4631,49.68%,50.32%,48.3,372,3.99%,59,753,75,2136,1040,899,304,5863,1203,2195,1793,974,23.55%,19.23%,10%,887,8501,9.52%,90.48%,8134,89,31,32,3,11,
0500000US19065,"Fayette County, Iowa",19604,9762,49.80%,50.20%,53.4,1157,5.90%,508,920,193,5643,1565,1753,736,12485,2489,6151,2485,1946,31.38%,12.68%,10%,520,18989,2.65%,97.35%,18053,200,40,78,1,31,
0500000US19067,"Floyd County, Iowa",15713,7864,50.05%,49.95%,57.3,510,3.25%,473,509,91,4056,1814,1574,559,10012,2133,4529,2323,1665,28.82%,14.78%,11%,550,15077,3.50%,96.50%,13907,415,29,293,12,14,
0500000US19069,"Franklin County, Iowa",10091,5032,49.87%,50.13%,59.8,633,6.27%,147,254,119,2533,1014,1085,237,6416,1322,2680,1268,1204,26.56%,12.57%,12%,1634,8385,16.19%,83.81%,8034,32,18,49,0,26,
0500000US19071,"Fremont County, Iowa",6895,3469,50.31%,49.69%,58.6,246,3.57%,112,198,32,1739,757,729,212,4694,941,1851,955,761,26.85%,13.85%,11%,190,6415,2.76%,97.24%,6145,10,19,8,5,20,
0500000US19073,"Greene County, Iowa",8923,4562,51.13%,48.87%,55,324,3.63%,205,187,89,2416,831,920,326,5888,1246,2621,1018,1009,29.37%,11.41%,11%,256,8515,2.87%,97.13%,8188,22,15,48,1,12,
0500000US19075,"Grundy County, Iowa",12262,6194,50.51%,49.49%,63.3,271,2.21%,276,426,74,2730,1337,1793,553,8199,2346,3006,1763,1867,24.51%,14.38%,15%,145,12184,1.18%,98.82%,11791,43,10,24,0,15,
0500000US19077,"Guthrie County, Iowa",10702,5376,50.23%,49.77%,61.2,345,3.22%,287,230,73,2810,962,1034,488,7125,1522,3097,1192,1107,28.94%,11.14%,10%,274,10349,2.56%,97.44%,9960,27,21,37,16,51,
0500000US19079,"Hamilton County, Iowa",14905,7532,50.53%,49.47%,56.5,476,3.19%,343,482,80,3358,1905,1918,608,9840,2526,3701,2387,1998,24.83%,16.01%,13%,1465,13574,9.83%,90.17%,12702,88,25,314,0,27,
0500000US19081,"Hancock County, Iowa",10709,5360,50.05%,49.95%,63.2,540,5.04%,351,243,70,2807,1057,1370,319,7111,1689,3158,1300,1440,29.49%,12.14%,13%,614,10181,5.73%,94.27%,9813,76,22,25,0,3,
0500000US19083,"Hardin County, Iowa",16924,8377,49.50%,50.50%,54.9,788,4.66%,466,548,180,4197,1619,1812,778,11148,2590,4663,2167,1992,27.55%,12.80%,12%,818,16060,4.83%,95.17%,15292,144,25,86,2,32,
0500000US19085,"Harrison County, Iowa",14043,6999,49.84%,50.16%,60.9,493,3.51%,318,430,96,3855,1090,1291,597,9146,1888,4173,1520,1387,29.72%,10.82%,10%,293,14289,2.09%,97.91%,13818,27,25,49,0,24,
0500000US19087,"Henry County, Iowa",19889,9806,49.30%,50.70%,51.4,722,3.63%,568,1060,100,4925,1530,2209,851,12576,3060,5493,2590,2309,27.62%,13.02%,12%,1083,19399,5.45%,94.55%,17643,501,60,451,8,73,
0500000US19089,"Howard County, Iowa",9201,4590,49.89%,50.11%,59.8,368,4.00%,269,275,46,2428,1006,881,281,5709,1162,2697,1281,927,29.31%,13.92%,10%,258,9211,2.80%,97.20%,8890,23,33,27,7,14,
0500000US19091,"Humboldt County, Iowa",9518,4754,49.95%,50.05%,58.2,557,5.85%,177,240,127,2520,1095,1079,257,6234,1336,2697,1335,1206,28.34%,14.03%,13%,430,9167,4.52%,95.48%,8823,53,16,21,6,22,
0500000US19093,"Ida County, Iowa",6862,3440,50.13%,49.87%,56.6,393,5.73%,204,178,44,1868,643,650,178,4329,828,2072,821,694,30.20%,11.96%,10%,255,6750,3.72%,96.28%,6554,28,0,18,11,16,
0500000US19095,"Iowa County, Iowa",16155,8051,49.84%,50.16%,58.3,567,3.51%,347,507,133,4188,1376,1802,670,10661,2472,4535,1883,1935,28.07%,11.66%,12%,495,16167,3.06%,96.94%,15394,111,29,84,1,57,
0500000US19097,"Jackson County, Iowa",19348,9621,49.73%,50.27%,57.7,1081,5.59%,502,629,141,5619,1320,1849,824,12659,2673,6121,1949,1990,31.64%,10.07%,10%,237,19248,1.22%,98.78%,18369,140,33,46,190,51,
0500000US19099,"Jasper County, Iowa",37032,18024,48.67%,51.33%,56.9,1399,3.78%,1222,1012,132,10768,3241,3536,1475,24537,5011,11990,4253,3668,32.38%,11.48%,10%,1087,36726,2.94%,97.06%,34445,683,91,215,30,104,
0500000US19101,"Jefferson County, Iowa",18153,9229,50.84%,49.16%,44.3,1574,8.67%,505,468,173,3402,1671,2782,2036,12180,4818,3907,2139,2955,21.52%,11.78%,16%,610,15053,3.36%,96.64%,13425,409,43,500,9,84,
0500000US19103,"Johnson County, Iowa",150819,76013,50.40%,49.60%,45.1,15011,9.95%,6107,17405,6176,14100,7539,25952,22542,85479,48494,20207,24944,32128,13.40%,16.54%,21%,10198,142656,6.76%,93.24%,114491,12643,193,8555,41,534,
0500000US19105,"Jones County, Iowa",20575,9970,48.46%,51.54%,52.3,871,4.23%,532,475,59,5802,1914,2070,863,13791,2933,6334,2389,2129,30.78%,11.61%,10%,497,20149,2.42%,97.58%,19002,437,53,58,2,63,
0500000US19107,"Keokuk County, Iowa",10163,4973,48.93%,51.07%,54.9,523,5.15%,212,369,29,2970,882,963,351,6645,1314,3182,1251,992,31.31%,12.31%,10%,215,9818,2.12%,97.88%,9476,47,4,16,0,7,
0500000US19109,"Kossuth County, Iowa",14864,7459,50.18%,49.82%,54.5,611,4.11%,402,511,109,3831,1592,1458,447,9789,1905,4233,2103,1567,28.48%,14.15%,11%,603,14225,4.06%,95.94%,13758,71,9,71,3,15,
0500000US19111,"Lee County, Iowa",33946,16870,49.70%,50.30%,54.1,1383,4.07%,920,1081,78,9229,3225,3275,1185,22487,4460,10149,4306,3353,29.90%,12.68%,10%,1110,32445,3.27%,96.73%,29888,896,48,139,8,69,
0500000US19113,"Linn County, Iowa",225601,114489,50.75%,49.25%,50.9,8577,3.80%,6720,9634,2489,40207,19677,35956,16059,144352,52015,46927,29311,38445,20.80%,12.99%,17%,8911,221388,3.95%,96.05%,187911,16200,382,5345,522,659,
0500000US19115,"Louisa County, Iowa",11125,5398,48.52%,51.48%,58,355,3.19%,318,394,45,2931,877,994,317,6535,1311,3249,1271,1039,29.20%,11.42%,9%,1728,9109,15.53%,84.47%,8485,73,11,265,0,14,
0500000US19117,"Lucas County, Iowa",8556,4218,49.30%,50.70%,60.4,413,4.83%,227,175,30,2534,583,745,246,5558,991,2761,758,775,32.27%,8.86%,9%,198,8436,2.31%,97.69%,8154,18,6,29,0,6,
0500000US19119,"Lyon County, Iowa",11800,5800,49.15%,50.85%,67,287,2.43%,459,235,33,2927,1152,1119,350,7021,1469,3386,1387,1152,28.69%,11.75%,10%,407,11527,3.45%,96.55%,11175,38,20,24,43,5,
0500000US19121,"Madison County, Iowa",16148,8108,50.21%,49.79%,65.1,221,1.37%,383,484,39,3758,1392,1939,866,10589,2805,4141,1876,1978,25.64%,11.62%,12%,316,16232,1.96%,98.04%,15504,44,15,83,9,57,
0500000US19123,"Mahaska County, Iowa",22351,11076,49.56%,50.45%,55.1,965,4.32%,515,1154,267,6071,1614,2246,920,13661,3166,6586,2768,2513,29.47%,12.38%,11%,480,21710,2.15%,97.85%,20259,384,41,250,15,34,
0500000US19125,"Marion County, Iowa",33193,16613,50.05%,49.95%,59.8,1065,3.21%,885,2231,166,7163,2261,4611,2173,20695,6784,8048,4492,4777,24.25%,13.53%,14%,700,32714,2.11%,97.89%,30918,281,64,401,21,86,
0500000US19127,"Marshall County, Iowa",39804,19886,49.96%,50.04%,54.6,2005,5.04%,1382,1036,557,8941,3115,3813,1665,22436,5478,10323,4151,4370,25.93%,10.43%,11%,9140,30965,22.96%,77.04%,27438,785,153,1514,33,59,
0500000US19129,"Mills County, Iowa",15023,7551,50.26%,49.74%,53.2,254,1.69%,310,569,71,3429,1258,1996,719,9762,2715,3739,1827,2067,24.89%,12.16%,14%,461,14023,3.07%,96.93%,13330,77,21,48,10,31,
0500000US19131,"Mitchell County, Iowa",10588,5359,50.61%,49.39%,59.9,173,1.63%,226,357,81,2670,1085,1191,415,6669,1606,2896,1442,1272,27.35%,13.62%,12%,193,10372,1.82%,98.18%,10080,42,3,45,4,23,
0500000US19133,"Monona County, Iowa",8675,4545,52.39%,47.61%,56.1,386,4.45%,189,163,108,2474,708,690,298,5831,988,2663,871,798,30.70%,10.04%,9%,236,8515,2.72%,97.28%,8051,28,146,27,2,25,
0500000US19135,"Monroe County, Iowa",7761,3930,50.64%,49.36%,56.8,268,3.45%,176,276,51,2089,498,872,201,4841,1073,2265,774,923,29.18%,9.97%,12%,117,7460,1.51%,98.49%,7192,18,12,16,2,31,
0500000US19137,"Montgomery County, Iowa",10016,5111,51.03%,48.97%,55.1,507,5.06%,339,285,12,2399,969,1046,325,6359,1371,2738,1254,1058,27.34%,12.52%,11%,371,9959,3.70%,96.30%,9603,25,18,21,2,7,
0500000US19139,"Muscatine County, Iowa",42703,21612,50.61%,49.39%,51.2,2118,4.96%,1413,1271,509,9903,3532,4227,1968,25278,6195,11316,4803,4736,26.50%,11.25%,11%,7769,35466,18.19%,81.81%,32633,1086,58,404,0,104,
0500000US19141,"O'Brien County, Iowa",13796,6923,50.18%,49.82%,58.7,392,2.84%,552,315,98,3475,1234,1601,470,8728,2071,4027,1549,1699,29.19%,11.23%,12%,985,13197,7.14%,92.86%,12609,159,39,79,11,26,
0500000US19143,"Osceola County, Iowa",6016,2950,49.04%,50.96%,58,366,6.08%,174,157,20,1537,703,484,152,3734,636,1711,860,504,28.44%,14.30%,8%,603,5589,10.02%,89.98%,5341,28,18,21,36,11,
0500000US19145,"Page County, Iowa",15205,7182,47.23%,52.77%,52.4,865,5.69%,369,378,56,4078,1364,1653,615,10345,2268,4447,1742,1709,29.25%,11.46%,11%,464,14747,3.05%,96.95%,13686,365,60,117,0,15,
0500000US19147,"Palo Alto County, Iowa",8941,4435,49.60%,50.40%,53.2,106,1.19%,167,457,29,1838,800,1106,425,5728,1531,2005,1257,1135,22.42%,14.06%,13%,274,8722,3.06%,96.94%,8391,52,15,37,6,21,
0500000US19149,"Plymouth County, Iowa",25141,12779,50.83%,49.17%,62.5,591,2.35%,548,820,271,5868,2337,2862,919,15890,3781,6416,3157,3133,25.52%,12.56%,12%,1496,24202,5.95%,94.05%,22941,354,48,111,117,54,
0500000US19151,"Pocahontas County, Iowa",6725,3435,51.08%,48.92%,56.5,208,3.09%,99,215,94,1733,675,613,143,4247,756,1832,890,707,27.24%,13.23%,11%,354,6724,5.26%,94.74%,6383,66,10,29,23,24,
0500000US19153,"Polk County, Iowa",485418,246180,50.72%,49.29%,48.4,21804,4.49%,12260,17987,6597,79884,32365,83767,37409,297137,121176,92144,50352,90364,18.98%,10.37%,19%,48055,444346,9.90%,90.10%,362260,34990,1081,24313,280,1713,
0500000US19155,"Pottawattamie County, Iowa",93478,47397,50.70%,49.30%,48.7,4457,4.77%,3505,3228,547,21046,7460,9512,4403,56998,13915,24551,10688,10059,26.26%,11.43%,11%,7660,86007,8.19%,91.81%,79181,1836,391,773,76,278,
0500000US19157,"Poweshiek County, Iowa",18391,9478,51.54%,48.46%,49.1,773,4.20%,749,1734,167,4618,1111,1774,1590,11241,3364,5367,2845,1941,29.18%,15.47%,11%,529,18133,2.88%,97.12%,17004,320,53,221,21,29,
0500000US19159,"Ringgold County, Iowa",4922,2522,51.24%,48.76%,55.2,92,1.87%,129,193,7,1285,424,441,211,3103,652,1414,617,448,28.73%,12.54%,9%,71,4592,1.44%,98.56%,4447,2,7,8,0,3,
0500000US19161,"Sac County, Iowa",9711,4907,50.53%,49.47%,58.4,401,4.13%,232,338,51,2499,932,901,328,6380,1229,2731,1270,952,28.12%,13.08%,10%,354,9460,3.65%,96.35%,9161,46,11,31,6,23,
0500000US19163,"Scott County, Iowa",172938,88125,50.96%,49.04%,49.7,8887,5.14%,4671,6133,1698,33704,13359,24064,14247,109928,38311,38375,19492,25762,22.19%,11.27%,15%,12092,162577,6.99%,93.01%,134578,13701,324,4824,57,523,
0500000US19165,"Shelby County, Iowa",11544,5901,51.12%,48.88%,58.6,504,4.37%,210,214,131,2882,1270,1285,451,7550,1736,3092,1484,1416,26.78%,12.86%,12%,412,11334,3.57%,96.43%,10890,53,29,49,3,9,
0500000US19167,"Sioux County, Iowa",34900,17314,49.61%,50.39%,62.7,720,2.06%,825,2852,690,6078,3092,4367,1763,19098,6130,6903,5944,5057,19.78%,17.03%,14%,4914,30958,14.08%,85.92%,29919,184,87,219,5,42,
0500000US19169,"Story County, Iowa",97355,46456,47.72%,52.28%,39.4,10451,10.73%,4717,21513,3125,8817,5443,15461,11328,49937,26789,13534,26956,18586,13.90%,27.69%,19%,5032,93505,5.17%,94.83%,79944,2980,226,5444,29,335,
0500000US19171,"Tama County, Iowa",16962,8610,50.76%,49.24%,54.9,1012,5.97%,569,452,111,4720,1522,1311,483,10488,1794,5289,1974,1422,31.18%,11.64%,8%,1804,15331,10.64%,89.36%,13284,125,1258,80,2,28,
0500000US19173,"Taylor County, Iowa",6160,3087,50.11%,49.89%,57.7,167,2.71%,133,176,0,1663,644,479,149,3838,628,1796,820,479,29.16%,13.31%,8%,399,5497,6.48%,93.52%,5304,1,13,15,1,21,
0500000US19175,"Union County, Iowa",12303,6318,51.35%,48.65%,52,527,4.28%,381,508,83,2773,818,1305,588,7650,1893,3154,1326,1388,25.64%,10.78%,11%,399,11739,3.24%,96.76%,11223,114,25,65,7,10,
0500000US19177,"Van Buren County, Iowa",7104,3460,48.71%,51.30%,59.6,326,4.59%,118,164,24,1869,631,545,277,4469,822,1987,795,569,27.97%,11.19%,8%,114,7089,1.60%,98.40%,6878,26,6,24,0,3,
0500000US19179,"Wapello County, Iowa",35102,17629,50.22%,49.78%,50.5,2475,7.05%,980,1572,158,8573,2735,2964,1764,21100,4728,9553,4307,3122,27.21%,12.27%,9%,4332,31105,12.34%,87.66%,27295,1443,66,622,518,88,
0500000US19181,"Warren County, Iowa",50867,25885,50.89%,49.11%,55.8,1446,2.84%,983,2736,604,10603,4032,7350,3173,32235,10523,11586,6768,7954,22.78%,13.31%,16%,1658,50745,3.26%,96.74%,47897,452,80,380,17,167,
0500000US19183,"Washington County, Iowa",22100,11169,50.54%,49.46%,57.7,726,3.29%,666,515,97,5956,1594,2365,932,13748,3297,6622,2109,2462,29.96%,9.54%,11%,1612,20953,7.29%,92.71%,19958,177,19,113,3,82,
0500000US19185,"Wayne County, Iowa",6426,3293,51.25%,48.76%,57.7,385,5.99%,150,194,4,1891,581,428,191,3861,619,2041,775,432,31.76%,12.06%,7%,61,6436,0.95%,99.05%,6228,10,17,24,1,11,
0500000US19187,"Webster County, Iowa",36348,17481,48.09%,51.91%,44.7,2618,7.20%,1494,1893,177,8339,3274,3667,1506,22421,5173,9833,5167,3844,27.05%,14.22%,11%,2063,34936,5.68%,94.32%,31372,1773,112,295,16,79,
0500000US19189,"Winnebago County, Iowa",10474,5272,50.33%,49.67%,49.8,274,2.62%,412,507,101,2431,1077,1301,334,6645,1635,2843,1584,1402,27.14%,15.12%,13%,594,10085,5.67%,94.33%,9472,204,13,94,3,37,
0500000US19191,"Winneshiek County, Iowa",20090,10130,50.42%,49.58%,53.9,453,2.25%,383,2388,232,4545,1998,2451,1491,12716,3942,4928,4386,2683,24.53%,21.83%,13%,585,19485,2.91%,97.09%,18705,119,19,178,12,33,
0500000US19193,"Woodbury County, Iowa",102687,51803,50.45%,49.55%,48.9,5089,4.96%,2914,4985,804,20938,7111,10556,4985,57856,15541,23852,12096,11360,23.23%,11.78%,11%,18746,87195,18.26%,81.74%,72237,5076,1893,2957,651,358,
0500000US19195,"Worth County, Iowa",7422,3641,49.06%,50.94%,54.7,241,3.25%,157,245,99,2043,781,673,298,4974,971,2200,1026,772,29.64%,13.82%,10%,211,7232,2.84%,97.16%,6946,60,7,26,1,14,
0500000US19197,"Wright County, Iowa",12644,6347,50.20%,49.80%,54.8,580,4.59%,342,334,72,3380,956,1106,330,8146,1436,3722,1290,1178,29.44%,10.20%,9%,2394,10549,18.93%,81.07%,10107,73,15,67,8,15,
0500000US20001,"Allen County, Kansas",12503,6395,51.15%,48.85%,51.3,957,7.65%,432,433,143,3073,870,1080,471,7886,1551,3505,1303,1223,28.03%,10.42%,10%,502,12024,4.02%,95.98%,10991,173,135,67,2,39,
0500000US20003,"Anderson County, Kansas",7877,3980,50.53%,49.47%,56,337,4.28%,131,339,14,2133,339,551,431,4711,982,2264,678,565,28.74%,8.61%,7%,155,7681,1.97%,98.03%,7259,26,46,47,0,26,
0500000US20005,"Atchison County, Kansas",16210,8371,51.64%,48.36%,46.7,889,5.48%,982,1055,119,4281,803,1239,876,9431,2115,5263,1858,1358,32.47%,11.46%,8%,583,15765,3.60%,96.40%,13925,785,78,80,6,49,
0500000US20007,"Barber County, Kansas",4493,2175,48.41%,51.59%,57.4,423,9.41%,91,139,14,1063,299,426,212,2857,638,1154,438,440,25.68%,9.75%,10%,162,4066,3.61%,96.39%,3814,7,34,16,5,11,
0500000US20009,"Barton County, Kansas",26209,13485,51.45%,48.55%,54.4,1523,5.81%,741,1038,108,5484,2160,2626,1174,15818,3800,6225,3198,2734,23.75%,12.20%,10%,4127,21366,15.75%,84.25%,19911,293,90,80,3,63,
0500000US20011,"Bourbon County, Kansas",14539,7398,50.88%,49.12%,55.4,685,4.71%,233,813,30,3116,1063,1401,622,8744,2023,3349,1876,1431,23.03%,12.90%,10%,386,13974,2.65%,97.35%,12451,454,88,98,2,40,
0500000US20013,"Brown County, Kansas",9575,4935,51.54%,48.46%,56.1,659,6.88%,218,223,63,2508,629,939,306,6036,1245,2726,852,1002,28.47%,8.90%,10%,352,9156,3.68%,96.32%,7683,97,795,42,6,25,
0500000US20015,"Butler County, Kansas",66890,33198,49.63%,50.37%,58.1,2647,3.96%,1821,2930,363,12360,4368,8765,4641,40918,13406,14181,7298,9128,21.20%,10.91%,14%,3578,63802,5.35%,94.65%,56846,1398,489,996,37,222,
0500000US20017,"Chase County, Kansas",2604,1276,49.00%,51.00%,57.7,59,2.27%,132,84,0,533,131,369,125,1711,494,665,215,369,25.54%,8.26%,14%,222,2350,8.53%,91.47%,2228,18,8,8,1,9,
0500000US20019,"Chautauqua County, Kansas",3280,1545,47.10%,52.90%,56.4,178,5.43%,43,77,20,810,258,244,106,2063,350,853,335,264,26.01%,10.21%,8%,138,3241,4.21%,95.79%,2822,23,185,18,0,2,
0500000US20021,"Cherokee County, Kansas",20017,10250,51.21%,48.79%,50.2,932,4.66%,649,648,84,4511,1312,1835,908,12140,2743,5160,1960,1919,25.78%,9.79%,10%,514,18848,2.57%,97.43%,16241,79,771,65,26,34,
0500000US20023,"Cheyenne County, Kansas",2639,1320,50.02%,49.98%,51.1,231,8.75%,48,61,11,573,205,390,104,1771,494,621,266,401,23.53%,10.08%,15%,238,2378,9.02%,90.98%,2223,6,7,12,0,4,
0500000US20025,"Clark County, Kansas",2006,957,47.71%,52.29%,57.8,95,4.74%,52,23,13,339,167,323,113,1343,436,391,190,336,19.49%,9.47%,17%,203,1788,10.12%,89.88%,1668,1,20,24,1,7,
0500000US20027,"Clay County, Kansas",8030,4011,49.95%,50.05%,60.1,302,3.76%,150,281,17,2037,471,1048,528,5354,1576,2187,752,1065,27.24%,9.36%,13%,218,7899,2.71%,97.29%,7486,50,34,49,0,10,
0500000US20029,"Cloud County, Kansas",8831,4400,49.82%,50.18%,53.6,447,5.06%,380,325,33,1899,875,837,584,5571,1421,2279,1200,870,25.81%,13.59%,10%,319,8713,3.61%,96.39%,8235,123,40,40,4,11,
0500000US20031,"Coffey County, Kansas",8218,4059,49.39%,50.61%,58.8,352,4.28%,192,162,158,1954,487,985,404,5495,1389,2146,649,1143,26.11%,7.90%,14%,221,8139,2.69%,97.31%,7670,45,36,44,1,19,
0500000US20033,"Comanche County, Kansas",1759,889,50.54%,49.46%,52.4,39,2.22%,14,78,0,488,115,186,39,1254,225,502,193,186,28.54%,10.97%,11%,98,1591,5.57%,94.43%,1520,10,2,0,1,3,
0500000US20035,"Cowley County, Kansas",35090,17484,49.83%,50.17%,49.9,2149,6.12%,1021,1804,267,6831,2867,3249,2015,21116,5264,7852,4671,3516,22.38%,13.31%,10%,3971,30578,11.32%,88.68%,26227,865,626,499,179,73,
0500000US20037,"Crawford County, Kansas",38874,19278,49.59%,50.41%,44.1,3500,9.00%,1456,4498,551,7287,2065,4496,2446,21924,6942,8743,6563,5047,22.49%,16.88%,13%,2716,36256,6.99%,93.01%,31937,899,320,461,191,120,
0500000US20039,"Decatur County, Kansas",2826,1415,50.07%,49.93%,56.9,274,9.70%,82,75,4,790,179,373,53,1973,426,872,254,377,30.86%,8.99%,13%,76,2688,2.69%,97.31%,2565,9,7,10,0,3,
0500000US20041,"Dickinson County, Kansas",18614,9284,49.88%,50.12%,56.4,655,3.52%,435,475,112,4094,1225,2366,802,12039,3168,4529,1700,2478,24.33%,9.13%,13%,905,17497,4.86%,95.14%,16451,105,74,74,20,68,
0500000US20043,"Doniphan County, Kansas",7616,3752,49.27%,50.74%,52.8,382,5.02%,403,623,41,1691,430,706,321,4619,1027,2094,1053,747,27.49%,13.83%,10%,204,7306,2.68%,97.32%,6614,266,66,32,19,28,
0500000US20045,"Douglas County, Kansas",121304,61062,50.34%,49.66%,42.8,10088,8.32%,5735,17306,4187,13221,4721,19727,16597,67664,36324,18956,22027,23914,15.63%,18.16%,20%,8295,110490,6.84%,93.16%,90281,5104,2579,4657,84,523,
0500000US20047,"Edwards County, Kansas",2822,1408,49.89%,50.11%,58.5,101,3.58%,49,43,0,596,203,332,86,1819,418,645,246,332,22.86%,8.72%,12%,623,2284,22.08%,77.92%,2157,14,15,1,1,2,
0500000US20049,"Elk County, Kansas",2502,1264,50.52%,49.48%,66.3,146,5.84%,24,19,11,751,145,173,159,1677,332,775,164,184,30.98%,6.55%,7%,101,2382,4.04%,95.96%,2214,1,43,3,0,0,
0500000US20051,"Ellis County, Kansas",28747,14556,50.64%,49.37%,48.5,1601,5.57%,703,3056,623,4394,1678,4363,2386,16771,6749,5097,4734,4986,17.73%,16.47%,17%,2016,26918,7.01%,92.99%,25109,318,65,265,0,82,
0500000US20053,"Ellsworth County, Kansas",6176,2645,42.83%,57.17%,56.8,145,2.35%,128,233,72,1433,435,775,292,4125,1067,1561,668,847,25.28%,10.82%,14%,365,6011,5.91%,94.09%,5455,254,39,23,0,8,
0500000US20055,"Finney County, Kansas",36451,17613,48.32%,51.68%,51.8,2136,5.86%,1228,1564,222,5198,1747,2461,1360,15540,3821,6426,3311,2683,17.63%,9.08%,7%,19883,18587,54.55%,45.45%,14514,1362,164,1512,3,155,
0500000US20057,"Ford County, Kansas",33718,16150,47.90%,52.10%,51.7,1120,3.32%,1126,1380,174,5154,2221,2135,1303,14939,3438,6280,3601,2309,18.63%,10.68%,7%,19666,14621,58.32%,41.68%,12455,885,101,394,6,90,
0500000US20059,"Franklin County, Kansas",25643,12717,49.59%,50.41%,55.7,1263,4.93%,916,971,109,6447,1586,2218,1246,15901,3464,7363,2557,2327,28.71%,9.97%,9%,1147,24849,4.47%,95.53%,22818,303,190,103,7,78,
0500000US20061,"Geary County, Kansas",33309,15500,46.53%,53.47%,61.8,2189,6.57%,1977,2417,290,4155,2741,2619,1480,16943,4099,6132,5158,2909,18.41%,15.49%,9%,5776,30963,17.34%,82.66%,19957,6062,207,1183,452,189,
0500000US20063,"Gove County, Kansas",2650,1300,49.06%,50.94%,67,65,2.45%,50,38,35,726,250,285,90,1764,375,776,288,320,29.28%,10.87%,12%,83,2635,3.13%,96.87%,2486,3,3,15,1,16,
0500000US20065,"Graham County, Kansas",2464,1310,53.17%,46.83%,53.1,106,4.30%,10,90,8,572,174,363,103,1608,466,582,264,371,23.62%,10.71%,15%,62,2353,2.52%,97.48%,2179,55,8,14,0,14,
0500000US20067,"Grant County, Kansas",7324,3507,47.88%,52.12%,54.6,593,8.10%,244,237,0,1263,416,635,265,3518,900,1507,653,635,20.58%,8.92%,9%,3862,3490,52.73%,47.27%,3211,10,55,8,3,10,
0500000US20069,"Gray County, Kansas",6020,2972,49.37%,50.63%,65.3,99,1.64%,106,196,43,850,454,725,156,2947,881,956,650,768,15.88%,10.80%,13%,839,4814,13.94%,86.06%,4629,19,5,14,0,8,
0500000US20071,"Greeley County, Kansas",1156,622,53.81%,46.19%,61.4,76,6.57%,38,61,6,183,117,139,53,617,192,221,178,145,19.12%,15.40%,13%,199,1085,17.21%,82.79%,1036,0,4,5,0,10,
0500000US20073,"Greenwood County, Kansas",6010,2938,48.89%,51.12%,53.2,247,4.11%,76,198,23,1617,373,642,237,4032,879,1693,571,665,28.17%,9.50%,11%,204,5812,3.39%,96.61%,5406,28,32,36,1,15,
0500000US20075,"Hamilton County, Kansas",2552,1205,47.22%,52.78%,50.5,172,6.74%,71,48,0,624,104,244,61,1264,305,695,152,244,27.23%,5.96%,10%,1084,1434,42.48%,57.52%,1361,10,12,5,0,2,
0500000US20077,"Harper County, Kansas",5506,2731,49.60%,50.40%,54.2,418,7.59%,120,113,11,1496,249,371,252,3447,623,1616,362,382,29.35%,6.57%,7%,425,5060,7.72%,92.28%,4714,16,74,15,2,4,
0500000US20079,"Harvey County, Kansas",34434,17317,50.29%,49.71%,57,944,2.74%,935,1549,231,5222,2279,4750,2512,20631,7262,6157,3828,4981,17.88%,11.12%,14%,4055,29969,11.78%,88.22%,27349,596,183,260,10,82,
0500000US20081,"Haskell County, Kansas",3990,2039,51.10%,48.90%,62.7,153,3.83%,79,83,12,571,195,291,154,1841,445,650,278,303,16.29%,6.97%,8%,1119,2661,28.05%,71.95%,2578,9,8,1,0,7,
0500000US20083,"Hodgeman County, Kansas",1872,945,50.48%,49.52%,64.2,76,4.06%,58,61,0,261,149,307,123,1178,430,319,210,307,17.04%,11.22%,16%,96,1627,5.13%,94.87%,1546,14,7,10,1,2,
0500000US20085,"Jackson County, Kansas",13249,6639,50.11%,49.89%,58,420,3.17%,278,462,126,3660,672,1148,632,8418,1780,3938,1134,1274,29.72%,8.56%,10%,630,12602,4.76%,95.24%,10534,95,1098,29,18,37,
0500000US20087,"Jefferson County, Kansas",18974,9414,49.62%,50.39%,61.2,428,2.26%,546,403,55,5196,845,2227,1047,12536,3274,5742,1248,2282,30.26%,6.58%,12%,567,17801,2.99%,97.01%,16549,99,124,41,27,29,
0500000US20089,"Jewell County, Kansas",2854,1404,49.19%,50.81%,66.5,192,6.73%,30,45,20,827,232,292,137,2026,429,857,277,312,30.03%,9.71%,11%,62,2870,2.17%,97.83%,2743,4,10,10,0,8,
0500000US20091,"Johnson County, Kansas",597574,304249,50.91%,49.09%,57.2,13013,2.18%,13021,18833,10458,56504,30743,140107,87107,389187,227214,69525,49576,150565,11.63%,8.30%,25%,54389,555474,9.10%,90.90%,460399,28092,1595,32856,346,2393,
0500000US20093,"Kearny County, Kansas",3863,2059,53.30%,46.70%,48,303,7.84%,218,158,18,784,267,218,153,1734,371,1002,425,236,25.94%,11.00%,6%,1396,2587,36.14%,63.86%,2378,34,10,5,1,2,
0500000US20095,"Kingman County, Kansas",7173,3591,50.06%,49.94%,60.7,172,2.40%,59,265,56,1661,433,901,309,4757,1210,1720,698,957,23.98%,9.73%,13%,268,7202,3.74%,96.26%,6829,28,27,33,4,16,
0500000US20097,"Kiowa County, Kansas",2483,1275,51.35%,48.65%,53.2,62,2.50%,53,184,24,488,181,265,118,1422,383,541,365,289,21.79%,14.70%,12%,87,2373,3.50%,96.50%,2158,43,10,16,4,6,
0500000US20099,"Labette County, Kansas",19938,10080,50.56%,49.44%,53.1,924,4.63%,465,527,92,4170,1679,1938,1025,12277,2963,4635,2206,2030,23.25%,11.06%,10%,939,19245,4.71%,95.29%,16077,838,425,90,9,43,
0500000US20101,"Lane County, Kansas",1523,757,49.71%,50.30%,65.1,82,5.38%,38,20,8,360,125,137,107,1026,244,398,145,145,26.13%,9.52%,10%,143,1431,9.39%,90.61%,1375,0,8,0,2,0,
0500000US20103,"Leavenworth County, Kansas",81499,37955,46.57%,53.43%,53,2757,3.38%,2531,2745,756,15750,4916,10899,7642,51407,18541,18281,7661,11655,22.43%,9.40%,14%,5602,76279,6.87%,93.13%,62503,6656,589,1060,138,253,
0500000US20105,"Lincoln County, Kansas",3013,1487,49.35%,50.65%,58.2,176,5.84%,74,55,11,574,251,313,232,1993,545,648,306,324,21.51%,10.16%,11%,130,2809,4.31%,95.69%,2691,6,13,8,0,12,
0500000US20107,"Linn County, Kansas",9687,4786,49.41%,50.59%,61.5,723,7.46%,416,72,14,2764,584,821,383,6308,1204,3180,656,835,32.83%,6.77%,9%,238,9353,2.46%,97.54%,8782,62,46,20,8,16,
0500000US20109,"Logan County, Kansas",2789,1359,48.73%,51.27%,62.2,176,6.31%,45,91,17,546,296,274,79,1747,353,591,387,291,21.19%,13.88%,10%,195,2567,6.99%,93.01%,2457,4,0,10,2,10,
0500000US20111,"Lyon County, Kansas",33237,17140,51.57%,48.43%,47.1,2579,7.76%,1339,3777,496,6242,1453,3316,2033,17533,5349,7581,5230,3812,22.81%,15.74%,11%,7256,24923,21.83%,78.17%,22219,599,122,566,5,225,
0500000US20113,"McPherson County, Kansas",28557,14512,50.82%,49.18%,60.7,923,3.23%,712,1506,319,5293,2144,4004,1611,17806,5615,6005,3650,4323,21.03%,12.78%,15%,1592,28631,5.57%,94.43%,26519,475,93,213,8,140,
0500000US20115,"Marion County, Kansas",11865,5892,49.66%,50.34%,53.8,432,3.64%,266,760,39,2384,680,1531,773,7445,2304,2650,1440,1570,22.33%,12.14%,13%,442,11381,3.73%,96.27%,10750,118,35,39,7,67,
0500000US20117,"Marshall County, Kansas",9713,4869,50.13%,49.87%,57.8,153,1.58%,287,230,37,2789,767,854,447,6190,1301,3076,997,891,31.67%,10.26%,9%,227,9811,2.34%,97.66%,9410,39,23,41,0,13,
0500000US20119,"Meade County, Kansas",4120,2055,49.88%,50.12%,55.1,157,3.81%,157,137,14,607,343,363,197,2174,560,764,480,377,18.54%,11.65%,9%,797,3258,19.34%,80.66%,3053,37,9,13,0,6,
0500000US20121,"Miami County, Kansas",33740,16782,49.74%,50.26%,59.6,1172,3.47%,837,1133,262,7373,1849,4585,2576,21975,7161,8210,2982,4847,24.33%,8.84%,14%,1196,32995,3.54%,96.46%,30472,430,152,161,8,86,
0500000US20123,"Mitchell County, Kansas",6053,2954,48.80%,51.20%,52.8,448,7.40%,175,280,54,1180,563,782,281,3843,1063,1355,843,836,22.39%,13.93%,14%,157,5639,2.59%,97.41%,5436,19,12,13,0,2,
0500000US20125,"Montgomery County, Kansas",32114,16083,50.08%,49.92%,50.4,2654,8.26%,801,1396,138,6816,2752,3110,1300,19682,4410,7617,4148,3248,23.72%,12.92%,10%,2414,29072,7.52%,92.48%,23571,1533,946,191,24,72,
0500000US20127,"Morris County, Kansas",5551,2753,49.60%,50.41%,63.3,222,4.00%,128,106,20,1450,391,762,317,3773,1079,1578,497,782,28.43%,8.95%,14%,227,5159,4.09%,95.91%,4897,16,10,18,1,12,
0500000US20129,"Morton County, Kansas",2656,1388,52.26%,47.74%,53.3,178,6.70%,77,32,0,569,202,222,76,1542,298,646,234,222,24.32%,8.81%,8%,591,2110,22.25%,77.75%,1940,17,10,31,9,12,
0500000US20131,"Nemaha County, Kansas",10109,4958,49.05%,50.96%,59,324,3.21%,406,218,75,2416,835,1213,569,6181,1782,2822,1053,1288,27.92%,10.42%,13%,266,10007,2.63%,97.37%,9622,64,26,35,7,10,
0500000US20133,"Neosho County, Kansas",16008,8238,51.46%,48.54%,54.1,791,4.94%,475,707,60,3476,1210,1311,842,9901,2153,3951,1917,1371,24.68%,11.98%,9%,910,14994,5.68%,94.32%,13767,131,127,84,6,25,
0500000US20135,"Ness County, Kansas",2838,1423,50.14%,49.86%,68.6,113,3.98%,44,108,45,630,251,353,84,1843,437,674,359,398,23.75%,12.65%,14%,305,2382,10.75%,89.25%,2305,2,9,2,0,6,
0500000US20137,"Norton County, Kansas",5416,2460,45.42%,54.58%,46.4,166,3.06%,273,75,4,1211,377,639,139,3593,778,1484,452,643,27.40%,8.35%,12%,311,5148,5.74%,94.26%,4690,199,33,35,2,9,
0500000US20139,"Osage County, Kansas",15855,7914,49.92%,50.09%,57.2,1054,6.65%,483,514,51,4320,956,1329,811,10017,2140,4803,1470,1380,30.29%,9.27%,9%,457,15309,2.88%,97.12%,14505,33,43,52,3,24,
0500000US20141,"Osborne County, Kansas",3494,1752,50.14%,49.86%,51,184,5.27%,81,91,30,846,366,428,105,2397,533,927,457,458,26.53%,13.08%,13%,66,3434,1.89%,98.11%,3285,1,19,18,0,3,
0500000US20143,"Ottawa County, Kansas",5776,2797,48.43%,51.58%,60.6,349,6.04%,207,124,52,1405,342,729,246,3869,975,1612,466,781,27.91%,8.07%,14%,144,5591,2.49%,97.51%,5268,30,22,10,0,15,
0500000US20145,"Pawnee County, Kansas",6539,2907,44.46%,55.54%,44.9,187,2.86%,128,135,31,1718,489,745,205,4544,950,1846,624,776,28.23%,9.54%,12%,522,5731,7.98%,92.02%,5154,246,24,28,0,27,
0500000US20147,"Phillips County, Kansas",5297,2638,49.80%,50.20%,55.5,225,4.25%,107,195,26,1304,427,610,259,3499,869,1411,622,636,26.64%,11.74%,12%,142,4839,2.68%,97.32%,4620,19,22,15,1,0,
0500000US20149,"Pottawatomie County, Kansas",24203,12157,50.23%,49.77%,62.2,726,3.00%,519,939,53,4524,1369,3440,1850,14529,5290,5043,2308,3493,20.84%,9.54%,14%,1429,23919,5.90%,94.10%,22065,271,109,194,27,70,
0500000US20151,"Pratt County, Kansas",9324,4657,49.95%,50.05%,50.4,436,4.68%,240,413,27,1500,677,1236,546,5540,1782,1740,1090,1263,18.66%,11.69%,14%,741,8416,7.95%,92.05%,7872,106,40,45,7,36,
0500000US20153,"Rawlins County, Kansas",2490,1193,47.91%,52.09%,65.2,71,2.85%,40,41,5,544,285,322,82,1774,404,584,326,327,23.45%,13.09%,13%,159,2402,6.39%,93.61%,2242,18,3,11,0,12,
0500000US20155,"Reno County, Kansas",62421,31066,49.77%,50.23%,50.5,3283,5.26%,1591,2531,243,12604,4934,5776,2829,38772,8605,14195,7465,6019,22.74%,11.96%,10%,6096,55802,9.77%,90.23%,50316,1744,397,333,41,173,
0500000US20157,"Republic County, Kansas",4607,2337,50.73%,49.27%,65.6,190,4.12%,24,183,38,1030,476,609,332,3201,941,1054,659,647,22.88%,14.30%,14%,91,4583,1.98%,98.02%,4402,15,13,11,9,0,
0500000US20159,"Rice County, Kansas",9532,4705,49.36%,50.64%,58.4,332,3.48%,203,840,94,1845,615,876,472,5670,1348,2048,1455,970,21.49%,15.26%,10%,1290,8137,13.53%,86.47%,7520,130,41,30,0,14,
0500000US20161,"Riley County, Kansas",74059,34964,47.21%,52.79%,37.3,8070,10.90%,5001,16129,2576,6177,3434,9651,8111,36183,17762,11178,19563,12227,15.09%,26.42%,17%,7470,64489,10.09%,89.91%,51807,4759,305,3325,224,413,
0500000US20163,"Rooks County, Kansas",4985,2581,51.78%,48.23%,58.3,88,1.77%,74,144,17,1003,458,627,230,3127,857,1077,602,644,21.60%,12.08%,13%,116,4803,2.33%,97.67%,4558,28,2,5,9,7,
0500000US20165,"Rush County, Kansas",2953,1452,49.17%,50.83%,50.1,113,3.83%,57,75,59,657,247,365,98,1967,463,714,322,424,24.18%,10.90%,14%,132,2824,4.47%,95.53%,2745,6,3,14,0,0,
0500000US20167,"Russell County, Kansas",6896,3507,50.86%,49.14%,53.1,425,6.16%,228,204,0,1346,499,775,377,4548,1152,1574,703,775,22.82%,10.19%,11%,236,6455,3.42%,96.58%,6039,60,29,28,0,13,
0500000US20169,"Saline County, Kansas",54384,27292,50.18%,49.82%,49.7,2021,3.72%,1675,2055,355,10939,3039,6633,3423,33978,10056,12614,5094,6988,23.19%,9.37%,13%,6642,47661,12.21%,87.79%,41506,1732,233,1109,26,162,
0500000US20171,"Scott County, Kansas",4893,2388,48.80%,51.20%,64.6,82,1.68%,185,81,35,884,198,579,221,2678,800,1069,279,614,21.85%,5.70%,13%,1027,4124,20.99%,79.01%,3895,13,20,15,2,3,
0500000US20173,"Sedgwick County, Kansas",515416,260861,50.61%,49.39%,49,31318,6.08%,15981,20569,4693,88227,28109,67595,37634,300897,105229,104208,48678,72288,20.22%,9.44%,14%,82630,441194,16.03%,83.97%,336271,45076,4450,22205,513,1979,
0500000US20175,"Seward County, Kansas",21902,10395,47.46%,52.54%,46.7,1445,6.60%,458,1021,207,3917,954,1007,427,8940,1434,4375,1975,1214,19.98%,9.02%,6%,14406,7558,65.77%,34.23%,5928,611,66,517,1,42,
0500000US20177,"Shawnee County, Kansas",177293,91675,51.71%,48.29%,50.8,7764,4.38%,5976,5664,1516,37751,8478,24384,13422,111364,37806,43727,14142,25900,24.66%,7.98%,15%,23861,155048,13.46%,86.54%,125873,13531,1575,2480,162,597,
0500000US20179,"Sheridan County, Kansas",2515,1239,49.26%,50.74%,55,60,2.39%,12,62,0,661,264,339,94,1739,433,673,326,339,26.76%,12.96%,13%,145,2302,5.77%,94.23%,2212,0,7,12,2,1,
0500000US20181,"Sherman County, Kansas",5904,2917,49.41%,50.59%,60,141,2.39%,73,284,36,1153,645,779,112,3686,891,1226,929,815,20.77%,15.74%,14%,773,5154,13.09%,86.91%,4798,103,12,13,1,15,
0500000US20183,"Smith County, Kansas",3594,1810,50.36%,49.64%,66.4,147,4.09%,105,75,18,1001,327,421,145,2537,566,1106,402,439,30.77%,11.19%,12%,67,3503,1.86%,98.14%,3370,12,15,9,0,5,
0500000US20185,"Stafford County, Kansas",4125,1979,47.98%,52.02%,61.7,144,3.49%,100,92,10,792,418,548,241,2627,789,892,510,558,21.62%,12.36%,14%,503,3569,12.19%,87.81%,3364,14,21,12,0,2,
0500000US20187,"Stanton County, Kansas",2030,996,49.06%,50.94%,55.6,292,14.38%,59,29,22,466,83,173,68,1099,241,525,112,195,25.86%,5.52%,10%,909,1175,44.78%,55.22%,1074,7,21,2,0,0,
0500000US20189,"Stevens County, Kansas",5498,2651,48.22%,51.78%,51.4,351,6.38%,107,309,1,900,297,296,123,2637,419,1007,606,297,18.32%,11.02%,5%,2020,3230,36.74%,63.26%,3007,20,20,22,0,16,
0500000US20191,"Sumner County, Kansas",22928,11331,49.42%,50.58%,55.5,1034,4.51%,542,668,133,5384,1383,2745,926,14482,3671,5926,2051,2878,25.85%,8.95%,13%,1254,21128,5.47%,94.53%,19347,200,215,73,0,93,
0500000US20193,"Thomas County, Kansas",7748,3985,51.43%,48.57%,57.5,353,4.56%,366,594,1,1140,826,793,463,4657,1256,1506,1420,794,19.44%,18.33%,10%,632,7298,8.16%,91.84%,6910,106,12,47,0,24,
0500000US20195,"Trego County, Kansas",2802,1394,49.75%,50.25%,61.7,36,1.28%,57,50,3,612,325,327,146,1991,473,669,375,330,23.88%,13.38%,12%,64,2744,2.28%,97.72%,2627,4,4,12,0,2,
0500000US20197,"Wabaunsee County, Kansas",6877,3373,49.05%,50.95%,58.2,183,2.66%,204,236,11,1725,494,688,456,4585,1144,1929,730,699,28.05%,10.62%,10%,317,6560,4.61%,95.39%,6185,31,29,12,4,21,
0500000US20199,"Wallace County, Kansas",1583,793,50.10%,49.91%,64.6,98,6.19%,28,56,5,346,133,260,62,1036,322,374,189,265,23.63%,11.94%,17%,80,1432,5.05%,94.95%,1344,3,1,0,2,3,
0500000US20201,"Washington County, Kansas",5474,2636,48.16%,51.85%,58.5,177,3.23%,143,157,22,1610,353,580,231,3597,811,1753,510,602,32.02%,9.32%,11%,275,5255,5.02%,94.98%,5084,13,2,4,2,6,
0500000US20203,"Wichita County, Kansas",2112,1096,51.89%,48.11%,58.2,23,1.09%,69,31,0,402,237,274,70,1306,344,471,268,274,22.30%,12.69%,13%,636,1516,30.11%,69.89%,1412,1,8,0,2,6,
0500000US20205,"Wilson County, Kansas",8600,4369,50.80%,49.20%,59.1,542,6.30%,160,328,7,2090,609,866,295,5347,1161,2250,937,873,26.16%,10.90%,10%,261,8363,3.03%,96.97%,7679,21,79,35,2,27,
0500000US20207,"Woodson County, Kansas",3117,1474,47.29%,52.71%,50.9,181,5.81%,73,99,2,888,265,332,136,2151,468,961,364,334,30.83%,11.68%,11%,71,3044,2.28%,97.72%,2864,8,27,0,0,7,
0500000US20209,"Wyandotte County, Kansas",165447,83199,50.29%,49.71%,42.9,11358,6.87%,5039,4839,1519,34206,8810,12633,6609,84327,19242,39245,13649,14152,23.72%,8.25%,9%,55814,113431,33.74%,66.26%,63079,33945,725,7621,364,573,
0500000US21001,"Adair County, Kentucky",19366,9742,50.31%,49.70%,49.6,738,3.81%,639,1335,297,5227,1244,1126,1279,10862,2405,5866,2579,1423,30.29%,13.32%,7%,643,18260,3.32%,96.68%,17044,498,26,63,6,70,
0500000US21003,"Allen County, Kentucky",21065,10612,50.38%,49.62%,50.8,2114,10.04%,728,487,69,5780,1181,1614,885,12083,2499,6508,1668,1683,30.89%,7.92%,8%,574,20014,2.72%,97.28%,18987,204,38,48,7,41,
0500000US21005,"Anderson County, Kentucky",22580,11483,50.86%,49.15%,51,1446,6.40%,770,392,148,5578,1647,2224,1302,14051,3526,6348,2039,2372,28.11%,9.03%,11%,521,23331,2.31%,97.69%,21654,482,50,104,4,68,
0500000US21007,"Ballard County, Kentucky",7914,3969,50.15%,49.85%,53.2,600,7.58%,356,179,2,2194,510,586,298,4971,884,2550,689,588,32.22%,8.71%,7%,93,7635,1.18%,98.82%,7074,208,7,29,0,5,
0500000US21009,"Barren County, Kentucky",44026,22865,51.94%,48.07%,50.6,4713,10.71%,1805,999,61,12969,2218,3180,1697,25164,4877,14774,3217,3241,33.56%,7.31%,7%,1889,42596,4.29%,95.71%,38804,1697,73,255,53,160,
0500000US21011,"Bath County, Kentucky",12421,6235,50.20%,49.80%,53.1,1390,11.19%,495,370,44,3583,502,773,509,6574,1282,4078,872,817,32.83%,7.02%,7%,182,12568,1.47%,98.53%,12125,127,4,16,1,15,
0500000US21013,"Bell County, Kentucky",26426,13456,50.92%,49.08%,47.8,3104,11.75%,779,654,111,7862,1259,835,939,13823,1774,8641,1913,946,32.70%,7.24%,4%,244,23853,0.92%,99.08%,22311,552,32,122,4,58,
0500000US21015,"Boone County, Kentucky",132368,66760,50.44%,49.57%,53.6,3873,2.93%,3692,4464,1120,25314,7887,17990,10014,81491,28004,29006,12351,19110,21.91%,9.33%,14%,7707,128261,5.82%,94.18%,112602,5609,194,3048,307,465,
0500000US21017,"Bourbon County, Kentucky",19998,10202,51.02%,48.99%,47.3,1156,5.78%,757,517,68,5094,772,1866,1311,11828,3177,5851,1289,1934,29.26%,6.45%,10%,1486,18766,7.43%,92.57%,16770,1033,28,77,8,70,
0500000US21019,"Boyd County, Kentucky",47361,23716,50.08%,49.93%,49,3241,6.84%,1413,1090,238,11332,3792,3727,3122,29866,6849,12745,4882,3965,26.91%,10.31%,8%,714,47547,1.51%,98.49%,44035,1306,89,277,6,116,
0500000US21021,"Boyle County, Kentucky",30090,15045,50.00%,50.00%,44.5,1538,5.11%,1639,1814,253,6924,1451,2793,2403,17844,5196,8563,3265,3046,28.46%,10.85%,10%,1490,29124,4.95%,95.05%,25074,2155,38,361,3,97,
0500000US21023,"Bracken County, Kentucky",8308,4110,49.47%,50.53%,57.9,674,8.11%,237,253,0,2724,457,355,363,5008,718,2961,710,355,35.64%,8.55%,4%,90,8310,1.08%,98.92%,7964,48,14,13,0,6,
0500000US21025,"Breathitt County, Kentucky",12802,6380,49.84%,50.16%,50.4,1802,14.08%,338,466,7,3513,660,606,856,7052,1462,3851,1126,613,30.08%,8.80%,5%,93,13625,0.73%,99.27%,13038,57,11,37,11,0,
0500000US21027,"Breckinridge County, Kentucky",20283,10171,50.15%,49.86%,50.8,1375,6.78%,658,585,124,5953,1088,1161,870,12160,2031,6611,1673,1285,32.59%,8.25%,6%,284,20148,1.40%,98.60%,18743,422,43,38,3,64,
0500000US21029,"Bullitt County, Kentucky",80921,40515,50.07%,49.93%,55.1,2765,3.42%,3037,2052,385,23536,5575,5885,2999,50374,8884,26573,7627,6270,32.84%,9.43%,8%,2117,80100,2.62%,97.38%,74787,1031,177,445,23,172,
0500000US21031,"Butler County, Kentucky",12756,6368,49.92%,50.08%,56.6,1049,8.22%,415,295,24,3985,691,663,587,7304,1250,4400,986,687,34.49%,7.73%,5%,592,11779,4.64%,95.36%,11370,15,22,21,3,23,
0500000US21033,"Caldwell County, Kentucky",12679,6506,51.31%,48.69%,56.5,1132,8.93%,225,338,42,3736,667,852,654,7824,1506,3961,1005,894,31.24%,7.93%,7%,198,12451,1.56%,98.44%,11190,654,21,53,2,29,
0500000US21035,"Calloway County, Kentucky",38991,20096,51.54%,48.46%,46.4,2654,6.81%,1623,4882,708,7612,1586,4229,3594,22203,7823,9235,6468,4937,23.68%,16.59%,13%,1353,35750,3.47%,96.53%,32235,1293,53,433,11,110,
0500000US21037,"Campbell County, Kentucky",93608,47793,51.06%,48.94%,47.3,5503,5.88%,2847,4522,1599,18391,5166,15600,8524,59605,24124,21238,9688,17199,22.69%,10.35%,18%,2309,90767,2.47%,97.53%,82743,2796,117,1024,30,370,
0500000US21039,"Carlisle County, Kentucky",4738,2376,50.15%,49.85%,54.9,344,7.26%,219,54,27,1456,284,263,208,2813,471,1675,338,290,35.35%,7.13%,6%,133,4693,2.81%,97.19%,4443,59,27,10,0,0,
0500000US21041,"Carroll County, Kentucky",10691,5202,48.66%,51.34%,46.7,1249,11.68%,398,218,85,2955,548,300,230,5764,530,3353,766,385,31.36%,7.16%,4%,795,10015,7.44%,92.56%,9401,169,20,44,3,11,
0500000US21043,"Carter County, Kentucky",26976,13585,50.36%,49.64%,51.3,3305,12.25%,768,1063,161,7348,1219,1336,1205,14697,2541,8116,2282,1497,30.09%,8.46%,6%,254,26373,0.94%,99.06%,25425,209,45,58,1,31,
0500000US21045,"Casey County, Kentucky",15968,8258,51.72%,48.28%,48.2,1287,8.06%,412,338,53,4422,748,737,511,8219,1248,4834,1086,790,30.27%,6.80%,5%,539,15402,3.38%,96.62%,14836,81,42,52,1,40,
0500000US21047,"Christian County, Kentucky",71470,33736,47.20%,52.80%,48,5510,7.71%,4961,4989,899,12114,4088,4801,2803,35140,7604,17075,9077,5700,23.89%,12.70%,8%,5752,66996,8.05%,91.95%,46400,15221,272,939,211,280,
0500000US21049,"Clark County, Kentucky",36152,18685,51.69%,48.32%,50.9,2564,7.09%,1150,761,273,9051,2283,3152,2000,22197,5152,10201,3044,3425,28.22%,8.42%,9%,1477,35495,4.09%,95.91%,32267,1635,63,209,14,79,
0500000US21051,"Clay County, Kentucky",20110,9523,47.36%,52.65%,48.7,2806,13.95%,609,425,40,5427,588,623,741,9588,1364,6036,1013,663,30.01%,5.04%,3%,353,19992,1.76%,98.24%,18686,816,26,21,11,21,
0500000US21053,"Clinton County, Kentucky",10175,5082,49.95%,50.05%,46.5,937,9.21%,389,177,58,2896,630,494,394,5448,888,3285,807,552,32.29%,7.93%,5%,245,9008,2.41%,97.59%,8680,39,10,10,3,15,
0500000US21055,"Crittenden County, Kentucky",8940,4409,49.32%,50.68%,52.3,408,4.56%,316,157,0,2877,462,484,379,5368,863,3193,619,484,35.72%,6.92%,5%,113,8877,1.26%,98.74%,8524,82,15,5,5,17,
0500000US21057,"Cumberland County, Kentucky",6660,3428,51.47%,48.53%,45.3,520,7.81%,228,95,19,2104,271,462,266,4007,728,2332,366,481,35.02%,5.50%,7%,77,5811,1.16%,98.84%,5445,150,1,2,6,6,
0500000US21059,"Daviess County, Kentucky",101001,51663,51.15%,48.85%,51.5,7392,7.32%,3150,3431,797,22702,7275,10010,6557,61516,16567,25852,10706,10807,25.60%,10.60%,11%,4145,99167,4.10%,95.90%,87327,4827,130,2417,59,311,
0500000US21061,"Edmonson County, Kentucky",12195,6094,49.97%,50.03%,56.3,888,7.28%,578,295,30,3519,628,511,413,6959,924,4097,923,541,33.60%,7.57%,4%,156,11970,1.28%,98.72%,11486,98,31,32,7,7,
0500000US21063,"Elliott County, Kentucky",7461,3264,43.75%,56.25%,47.4,722,9.68%,268,292,37,2466,258,330,181,4162,511,2734,550,367,36.64%,7.37%,5%,91,7263,1.22%,98.78%,6875,246,14,10,0,15,
0500000US21065,"Estill County, Kentucky",14187,7236,51.00%,49.00%,45.4,1436,10.12%,413,249,32,4434,525,781,402,7555,1183,4847,774,813,34.17%,5.46%,6%,131,14032,0.92%,99.08%,13619,30,23,7,0,11,
0500000US21067,"Fayette County, Kentucky",322200,164388,51.02%,48.98%,43.4,23287,7.23%,10969,23113,7459,39864,15776,53247,41241,193086,94488,50833,38889,60706,15.78%,12.07%,19%,29750,292820,9.23%,90.77%,215343,47501,480,13374,133,1667,
0500000US21069,"Fleming County, Kentucky",14519,7369,50.75%,49.25%,58,1078,7.42%,310,493,59,3846,1014,924,593,7886,1517,4156,1507,983,28.62%,10.38%,7%,218,14864,1.50%,98.50%,14314,148,22,17,3,42,
0500000US21071,"Floyd County, Kentucky",35931,18378,51.15%,48.85%,52.9,5237,14.58%,1073,1206,173,10158,1463,1765,1239,19643,3004,11231,2669,1938,31.26%,7.43%,5%,308,35634,0.86%,99.14%,34654,121,28,96,1,34,
0500000US21073,"Franklin County, Kentucky",50744,26198,51.63%,48.37%,46.3,3331,6.56%,1596,2027,244,10551,2591,6518,4457,32205,10975,12147,4618,6762,23.94%,9.10%,13%,2047,49494,4.03%,95.97%,41282,4444,91,1031,14,212,
0500000US21075,"Fulton County, Kentucky",6064,3040,50.13%,49.87%,38.5,774,12.76%,177,121,61,1690,286,434,151,3525,585,1867,407,495,30.79%,6.71%,8%,151,6364,2.49%,97.51%,4566,1433,13,17,11,27,
0500000US21077,"Gallatin County, Kentucky",8760,4254,48.56%,51.44%,48.3,658,7.51%,443,175,18,2861,356,441,125,4885,566,3304,531,459,37.72%,6.06%,5%,492,8198,5.62%,94.38%,7762,74,4,13,7,11,
0500000US21079,"Garrard County, Kentucky",17554,8975,51.13%,48.87%,58.8,1024,5.83%,513,344,66,4597,1186,1250,1282,10572,2532,5110,1530,1316,29.11%,8.72%,7%,451,16502,2.57%,97.43%,15433,301,27,51,8,37,
0500000US21081,"Grant County, Kentucky",25107,12740,50.74%,49.26%,51.2,1603,6.38%,983,753,91,7506,1246,1444,785,14007,2229,8489,1999,1535,33.81%,7.96%,6%,741,24200,2.95%,97.05%,22823,179,51,66,33,56,
0500000US21083,"Graves County, Kentucky",37125,18972,51.10%,48.90%,54,2971,8.00%,1681,882,225,10547,2612,2319,1812,22204,4131,12228,3494,2544,32.94%,9.41%,7%,2773,33876,7.47%,92.53%,30527,1551,96,173,3,76,
0500000US21085,"Grayson County, Kentucky",26313,13257,50.38%,49.62%,49.3,2280,8.66%,1037,633,45,8019,1273,1118,829,14815,1947,9056,1906,1163,34.42%,7.24%,4%,364,26056,1.38%,98.62%,24756,308,71,96,2,75,
0500000US21087,"Green County, Kentucky",11000,5577,50.70%,49.30%,51.3,827,7.52%,359,206,21,3267,491,464,460,6095,924,3626,697,485,32.96%,6.34%,4%,199,10908,1.81%,98.19%,10361,160,17,28,2,28,
0500000US21089,"Greenup County, Kentucky",35359,18151,51.33%,48.67%,54.5,2738,7.74%,647,1213,171,9383,3102,2226,1920,22683,4146,10030,4315,2397,28.37%,12.20%,7%,317,35645,0.90%,99.10%,33974,219,68,230,5,83,
0500000US21091,"Hancock County, Kentucky",8748,4264,48.74%,51.26%,59.2,864,9.88%,213,320,28,2471,578,461,378,5000,839,2684,898,489,30.68%,10.27%,6%,162,8933,1.85%,98.15%,8586,79,4,34,0,14,
0500000US21093,"Hardin County, Kentucky",109627,55119,50.28%,49.72%,51.2,5042,4.60%,5028,3058,639,21686,9139,9293,6738,66652,16031,26714,12197,9932,24.37%,11.13%,9%,6695,104007,6.11%,93.89%,81085,12510,378,2243,400,597,
0500000US21095,"Harlan County, Kentucky",26307,13656,51.91%,48.09%,54.3,3690,14.03%,386,951,66,6128,1854,899,1031,13543,1930,6514,2805,965,24.76%,10.66%,4%,265,26566,1.01%,98.99%,25001,541,54,85,0,48,
0500000US21097,"Harrison County, Kentucky",18763,9618,51.26%,48.74%,55.2,1243,6.62%,630,338,323,5242,912,997,1183,11004,2180,5872,1250,1320,31.30%,6.66%,7%,387,18305,2.06%,97.94%,17216,307,26,46,1,47,
0500000US21099,"Hart County, Kentucky",18833,9410,49.97%,50.04%,50,1514,8.04%,877,316,70,5342,825,839,613,9793,1452,6219,1141,909,33.02%,6.06%,5%,334,18954,1.77%,98.23%,17492,705,33,45,6,30,
0500000US21101,"Henderson County, Kentucky",45550,23560,51.72%,48.28%,52.4,3564,7.82%,1258,1238,312,11841,2971,3318,2481,27676,5799,13099,4209,3630,28.76%,9.24%,8%,1368,43425,3.00%,97.00%,37323,3632,78,239,41,167,
0500000US21103,"Henry County, Kentucky",15999,8084,50.53%,49.47%,52.6,1238,7.74%,672,307,39,4767,695,865,559,9248,1424,5439,1002,904,34.00%,6.26%,6%,545,15133,3.41%,96.59%,14065,349,45,35,0,45,
0500000US21105,"Hickman County, Kentucky",4461,2313,51.85%,48.15%,42.8,280,6.28%,202,47,5,1200,208,538,184,2692,722,1402,255,543,31.43%,5.72%,12%,102,4419,2.29%,97.71%,3866,380,6,11,0,1,
0500000US21107,"Hopkins County, Kentucky",45044,23121,51.33%,48.67%,50.4,4824,10.71%,1579,1089,130,12582,3212,2761,2300,27596,5061,14161,4301,2891,31.44%,9.55%,6%,1126,44297,2.50%,97.50%,39054,2902,70,230,29,119,
0500000US21109,"Jackson County, Kentucky",13368,6752,50.51%,49.49%,54.4,1544,11.55%,389,256,0,4213,517,628,331,6793,959,4602,773,628,34.43%,5.78%,5%,96,12859,0.72%,99.28%,12509,12,36,19,4,11,
0500000US21111,"Jefferson County, Kentucky",768419,397113,51.68%,48.32%,43.7,47386,6.17%,22284,26470,9425,139309,43700,108431,72139,483621,180570,161593,70170,117856,21.03%,9.13%,15%,59021,723948,7.68%,92.32%,490251,167067,1441,26944,559,3707,
0500000US21113,"Jessamine County, Kentucky",53476,27593,51.60%,48.40%,51.9,2638,4.93%,1938,2398,381,10931,3275,6189,4147,31219,10336,12869,5673,6570,24.07%,10.61%,12%,2384,50607,4.46%,95.54%,45191,2247,106,658,27,173,
0500000US21115,"Johnson County, Kentucky",22427,11374,50.72%,49.28%,54.9,1857,8.28%,581,772,177,6494,1270,1313,1142,13129,2455,7075,2042,1490,31.55%,9.11%,7%,198,22482,0.88%,99.12%,21860,42,39,101,4,16,
0500000US21117,"Kenton County, Kentucky",166552,84154,50.53%,49.47%,47.3,9254,5.56%,4564,5446,1781,31667,9614,24398,13977,103249,38375,36231,15060,26179,21.75%,9.04%,16%,7741,161323,4.65%,95.35%,142167,8061,234,2015,241,549,
0500000US21119,"Knott County, Kentucky",15041,7621,50.67%,49.33%,51.5,1842,12.25%,493,849,33,3122,977,769,871,7566,1640,3615,1826,802,24.03%,12.14%,5%,90,14161,0.60%,99.40%,13813,65,8,18,0,7,
0500000US21121,"Knox County, Kentucky",31288,16011,51.17%,48.83%,46.1,5391,17.23%,1035,1096,251,8317,966,1634,1534,16041,3168,9352,2062,1885,29.89%,6.59%,6%,347,29846,1.11%,98.89%,28509,281,82,85,1,34,
0500000US21123,"Larue County, Kentucky",14269,7208,50.52%,49.49%,55.6,1218,8.54%,413,438,37,3651,1054,659,886,8443,1545,4064,1492,696,28.48%,10.46%,5%,479,14388,3.36%,96.64%,13299,377,47,29,15,47,
0500000US21125,"Laurel County, Kentucky",60631,30860,50.90%,49.10%,53.3,6934,11.44%,1898,1544,234,15746,3363,3801,2943,34233,6744,17644,4907,4035,29.10%,8.09%,7%,1011,61602,1.67%,98.33%,58503,440,143,426,4,97,
0500000US21127,"Lawrence County, Kentucky",15604,7864,50.40%,49.60%,52.8,1779,11.40%,455,264,32,4703,575,558,439,8142,997,5158,839,590,33.06%,5.38%,4%,148,16145,0.95%,99.05%,15721,36,2,23,4,25,
0500000US21129,"Lee County, Kentucky",7088,3266,46.08%,53.92%,35.2,993,14.01%,329,101,24,1937,304,225,161,3542,386,2266,405,249,31.97%,5.71%,4%,60,7335,0.85%,99.15%,6887,280,1,0,0,19,
0500000US21131,"Leslie County, Kentucky",10081,5026,49.86%,50.14%,56.6,927,9.20%,248,337,35,2904,636,492,188,5629,680,3152,973,527,31.27%,9.65%,5%,72,10441,0.71%,99.29%,10170,39,15,15,0,4,
0500000US21133,"Letcher County, Kentucky",21936,11190,51.01%,48.99%,53.5,3034,13.83%,563,562,45,5669,1838,777,924,12245,1701,6232,2400,822,28.41%,10.94%,4%,133,21415,0.61%,99.39%,20773,87,30,57,0,27,
0500000US21135,"Lewis County, Kentucky",13345,6687,50.11%,49.89%,52.5,1935,14.50%,483,333,51,4041,886,495,321,7300,816,4524,1219,546,33.90%,9.13%,4%,83,12997,0.62%,99.38%,12599,36,18,9,4,6,
0500000US21137,"Lincoln County, Kentucky",24493,12460,50.87%,49.13%,57.5,1565,6.39%,885,530,16,7283,1241,1179,957,13722,2136,8168,1771,1195,33.35%,7.23%,5%,475,23800,1.94%,98.06%,22493,459,33,60,2,46,
0500000US21139,"Livingston County, Kentucky",9172,4599,50.14%,49.86%,57.7,636,6.93%,257,226,27,2709,616,586,372,5690,958,2966,842,613,32.34%,9.18%,7%,186,8702,2.03%,97.97%,8232,25,19,12,6,14,
0500000US21141,"Logan County, Kentucky",27049,13909,51.42%,48.58%,52.1,1645,6.08%,1046,674,60,8084,1209,1911,1278,16175,3189,9130,1883,1971,33.75%,6.96%,7%,853,26579,3.15%,96.85%,23681,1680,43,95,2,92,
0500000US21143,"Lyon County, Kentucky",8226,3871,47.06%,52.94%,48.7,344,4.18%,199,105,25,2761,682,550,468,5879,1018,2960,787,575,35.98%,9.57%,7%,152,8528,1.85%,98.15%,7733,507,25,34,0,21,
0500000US21145,"McCracken County, Kentucky",65485,34044,51.99%,48.01%,50.6,4027,6.15%,2188,1690,338,14820,5359,7426,4361,42455,11787,17008,7049,7764,25.97%,10.76%,12%,2135,65740,3.26%,96.74%,53801,7539,170,660,18,223,
0500000US21147,"McCreary County, Kentucky",17333,7978,46.03%,53.97%,48.6,2301,13.28%,546,513,64,4813,1024,640,398,9306,1038,5359,1537,704,30.92%,8.87%,4%,365,16523,2.11%,97.89%,15072,908,58,32,3,17,
0500000US21149,"McLean County, Kentucky",9202,4630,50.32%,49.69%,60.9,563,6.12%,259,237,17,2604,565,583,351,5686,934,2863,802,600,31.11%,8.72%,7%,164,8988,1.78%,98.22%,8691,47,10,13,2,28,
0500000US21151,"Madison County, Kentucky",92090,47317,51.38%,48.62%,46,6939,7.54%,4647,9441,1191,14987,5549,10795,7362,49796,18157,19634,14990,11986,21.32%,16.28%,13%,3064,89637,3.33%,96.67%,79591,3880,190,1006,56,260,
0500000US21153,"Magoffin County, Kentucky",12346,6163,49.92%,50.08%,52.1,1386,11.23%,307,342,75,3252,473,446,457,6193,903,3559,815,521,28.83%,6.60%,4%,66,11571,0.53%,99.47%,11335,14,14,5,6,13,
0500000US21155,"Marion County, Kentucky",19257,9501,49.34%,50.66%,43.2,1476,7.66%,574,652,74,5686,1114,895,969,10833,1864,6260,1766,969,32.51%,9.17%,5%,681,18900,3.54%,96.46%,16779,1209,0,123,47,53,
0500000US21157,"Marshall County, Kentucky",31225,15904,50.93%,49.07%,57.4,1668,5.34%,699,940,101,8100,2210,2669,2076,20626,4745,8799,3150,2770,28.18%,10.09%,9%,539,31120,1.73%,98.27%,29697,101,60,129,9,45,
0500000US21159,"Martin County, Kentucky",11421,5118,44.81%,55.19%,53.7,809,7.08%,353,409,18,2863,856,632,263,6271,895,3216,1265,650,28.16%,11.08%,6%,290,10997,2.54%,97.46%,10002,780,42,17,1,1,
0500000US21161,"Mason County, Kentucky",17122,8587,50.15%,49.85%,50.4,1130,6.60%,515,658,90,4020,1241,1415,1116,10299,2531,4535,1899,1505,26.49%,11.09%,9%,356,16764,2.08%,97.92%,14777,1017,29,107,0,43,
0500000US21163,"Meade County, Kentucky",28379,14107,49.71%,50.29%,56.9,1468,5.17%,1187,927,26,7031,2204,2093,1496,17591,3589,8218,3131,2119,28.96%,11.03%,7%,1133,28870,3.99%,96.01%,25912,952,132,217,73,121,
0500000US21165,"Menifee County, Kentucky",6463,2931,45.35%,54.65%,51.4,349,5.40%,139,149,74,1958,289,397,158,3465,555,2097,438,471,32.45%,6.78%,7%,57,6056,0.88%,99.12%,5873,30,12,2,2,1,
0500000US21167,"Mercer County, Kentucky",21690,10866,50.10%,49.90%,50.9,1167,5.38%,1004,572,25,5454,1668,1545,1272,13072,2817,6458,2240,1570,29.77%,10.33%,7%,703,21938,3.24%,96.76%,20100,748,40,74,14,82,
0500000US21169,"Metcalfe County, Kentucky",10062,5166,51.34%,48.66%,61.1,974,9.68%,447,196,21,2812,499,526,391,5531,917,3259,695,547,32.39%,6.91%,5%,230,10056,2.29%,97.71%,9620,114,3,7,0,33,
0500000US21171,"Monroe County, Kentucky",10616,5293,49.86%,50.14%,52.1,1142,10.76%,329,281,20,3097,545,431,568,5899,999,3426,826,451,32.27%,7.78%,4%,473,10865,4.46%,95.54%,10389,218,9,10,0,25,
0500000US21173,"Montgomery County, Kentucky",28042,14304,51.01%,48.99%,51.2,1991,7.10%,1099,803,74,7830,1169,1641,1347,16193,2988,8929,1972,1715,31.84%,7.03%,6%,925,27189,3.30%,96.70%,25363,614,26,145,1,65,
0500000US21175,"Morgan County, Kentucky",13270,5790,43.63%,56.37%,46.7,1099,8.28%,405,340,56,4122,483,721,754,7711,1475,4527,823,777,34.11%,6.20%,6%,417,13309,3.14%,96.86%,12510,492,20,17,4,10,
0500000US21177,"Muhlenberg County, Kentucky",30815,15411,50.01%,49.99%,52.5,1976,6.41%,1300,857,39,9042,2061,1809,1034,17939,2843,10342,2918,1848,33.56%,9.47%,6%,569,30359,1.85%,98.15%,28204,1203,64,58,3,62,
0500000US21179,"Nelson County, Kentucky",45915,23018,50.13%,49.87%,53.9,1695,3.69%,1708,1392,172,11264,3854,3659,2398,28884,6057,12972,5246,3831,28.25%,11.43%,8%,1214,45524,2.64%,97.36%,41113,2183,62,267,8,125,
0500000US21181,"Nicholas County, Kentucky",7189,3679,51.18%,48.83%,51.5,373,5.19%,232,263,35,2233,446,195,243,3955,438,2465,709,230,34.29%,9.86%,3%,154,7383,2.14%,97.86%,7124,41,10,7,2,14,
0500000US21183,"Ohio County, Kentucky",24081,12227,50.77%,49.23%,52.8,1768,7.34%,852,642,148,6613,1341,1102,1026,13446,2128,7465,1983,1250,31.00%,8.23%,5%,993,22779,4.12%,95.88%,21872,155,26,45,2,54,
0500000US21185,"Oldham County, Kentucky",66508,31645,47.58%,52.42%,59.3,972,1.46%,1872,2401,509,8604,3742,11212,7717,41419,18929,10476,6143,11721,15.75%,9.24%,18%,3235,64372,4.86%,95.14%,57836,2198,108,1160,17,214,
0500000US21187,"Owen County, Kentucky",10847,5285,48.72%,51.28%,54.5,1078,9.94%,392,206,173,3297,576,936,293,6168,1229,3689,782,1109,34.01%,7.21%,10%,251,11027,2.31%,97.69%,10486,83,22,18,4,17,
0500000US21189,"Owsley County, Kentucky",4416,2494,56.48%,43.52%,44.4,469,10.62%,131,217,0,1248,108,245,214,2191,459,1379,325,245,31.23%,7.36%,6%,42,4009,0.95%,99.05%,3905,11,1,1,5,4,
0500000US21191,"Pendleton County, Kentucky",14587,7091,48.61%,51.39%,51.5,1219,8.36%,590,310,75,4171,860,786,644,8431,1430,4761,1170,861,32.64%,8.02%,6%,201,14443,1.38%,98.62%,13833,56,21,30,3,42,
0500000US21193,"Perry County, Kentucky",26266,13232,50.38%,49.62%,50.7,2365,9.00%,696,875,47,6133,1930,1070,1577,14642,2647,6829,2805,1117,26.00%,10.68%,4%,221,28252,0.84%,99.16%,26748,374,51,255,1,29,
0500000US21195,"Pike County, Kentucky",58595,30009,51.21%,48.79%,55.4,6231,10.63%,1618,2107,476,16593,3076,2981,2820,32646,5801,18211,5183,3457,31.08%,8.85%,6%,695,57974,1.19%,98.81%,55635,485,68,369,11,92,
0500000US21197,"Powell County, Kentucky",12283,6301,51.30%,48.70%,55.4,1435,11.68%,492,288,32,3408,527,999,463,6763,1462,3900,815,1031,31.75%,6.64%,8%,197,12932,1.60%,98.40%,12507,64,17,30,0,23,
0500000US21199,"Pulaski County, Kentucky",64789,33430,51.60%,48.40%,49.8,6216,9.59%,1760,2215,313,15302,4613,4355,3326,38089,7681,17062,6828,4668,26.33%,10.54%,7%,1877,63157,2.90%,97.10%,59600,677,160,436,10,150,
0500000US21201,"Robertson County, Kentucky",2139,1188,55.54%,44.46%,50,264,12.34%,24,38,1,590,178,172,38,1283,210,614,216,173,28.71%,10.10%,8%,19,2174,0.89%,99.11%,2106,6,3,7,0,0,
0500000US21203,"Rockcastle County, Kentucky",16795,8640,51.44%,48.56%,52.6,1506,8.97%,520,454,52,5071,577,858,672,9526,1530,5591,1031,910,33.29%,6.14%,5%,172,15865,1.02%,98.98%,15316,52,33,28,0,24,
0500000US21205,"Rowan County, Kentucky",24534,12725,51.87%,48.13%,39.8,1854,7.56%,761,4245,229,4714,1129,1602,2059,12220,3661,5475,5374,1831,22.32%,21.90%,7%,541,24121,2.21%,97.79%,22773,372,32,157,5,105,
0500000US21207,"Russell County, Kentucky",17846,9133,51.18%,48.82%,50.2,1445,8.10%,501,595,40,4583,1143,1066,875,10232,1941,5084,1738,1106,28.49%,9.74%,6%,781,17210,4.38%,95.62%,16497,113,58,104,3,23,
0500000US21209,"Scott County, Kentucky",55961,28615,51.13%,48.87%,57.6,2375,4.24%,1876,2303,587,10863,3433,6697,4434,34004,11131,12739,5736,7284,22.76%,10.25%,13%,3103,54052,5.54%,94.46%,47704,2907,56,587,19,185,
0500000US21211,"Shelby County, Kentucky",48100,24696,51.34%,48.66%,55.8,2272,4.72%,1682,1445,473,9476,3005,5563,3680,28752,9243,11158,4450,6036,23.20%,9.25%,13%,5295,42770,11.01%,88.99%,37363,2700,76,361,22,212,
0500000US21213,"Simpson County, Kentucky",18319,9220,50.33%,49.67%,53.5,1163,6.35%,602,711,16,5721,1114,962,518,10785,1480,6323,1825,978,34.52%,9.96%,5%,648,18946,3.54%,96.46%,16201,1622,58,94,5,72,
0500000US21215,"Spencer County, Kentucky",18945,9424,49.74%,50.26%,62.1,733,3.87%,682,513,129,4880,1356,1730,1102,12249,2832,5562,1869,1859,29.36%,9.87%,10%,450,19040,2.38%,97.62%,17764,297,32,90,12,30,
0500000US21217,"Taylor County, Kentucky",25572,13157,51.45%,48.55%,51.5,1399,5.47%,868,1612,225,6267,1181,2390,1549,14715,3939,7135,2793,2615,27.90%,10.92%,10%,720,25303,2.82%,97.18%,22724,1252,26,244,10,110,
0500000US21219,"Todd County, Kentucky",12334,6220,50.43%,49.57%,59,1210,9.81%,382,196,47,3265,429,707,472,6415,1179,3647,625,754,29.57%,5.07%,6%,598,11645,4.85%,95.15%,10234,880,14,22,6,41,
0500000US21221,"Trigg County, Kentucky",14569,7228,49.61%,50.39%,57.1,650,4.46%,504,339,34,3399,1367,1228,748,9171,1976,3903,1706,1262,26.79%,11.71%,9%,317,13744,2.18%,97.82%,12202,950,34,27,6,34,
0500000US21223,"Trimble County, Kentucky",8528,4336,50.84%,49.16%,50.7,764,8.96%,362,254,42,2681,462,577,327,4999,904,3043,716,619,35.68%,8.40%,7%,192,8282,2.25%,97.75%,7914,28,29,27,4,8,
0500000US21225,"Union County, Kentucky",14582,7255,49.75%,50.25%,50.7,1768,12.12%,1292,695,31,4425,968,559,491,8691,1050,5717,1663,590,39.21%,11.40%,4%,188,13480,1.29%,98.71%,11802,1029,27,32,1,39,
0500000US21227,"Warren County, Kentucky",130836,66615,50.92%,49.09%,44.7,9400,7.18%,6301,11200,2081,21358,7115,15193,10500,70394,25693,27659,18315,17274,21.14%,14.00%,13%,9441,125113,7.22%,92.78%,97744,12804,235,7295,661,630,
0500000US21229,"Washington County, Kentucky",12044,6179,51.30%,48.70%,53,640,5.31%,477,337,54,3527,718,877,801,7254,1678,4004,1055,931,33.24%,8.76%,8%,470,11557,3.90%,96.10%,10397,652,25,38,5,52,
0500000US21231,"Wayne County, Kentucky",20447,10304,50.39%,49.61%,53,1869,9.14%,823,363,97,6102,848,1212,741,11172,1953,6925,1211,1309,33.87%,5.92%,6%,902,18653,4.41%,95.59%,17872,228,28,60,5,17,
0500000US21233,"Webster County, Kentucky",13021,6613,50.79%,49.21%,51.1,935,7.18%,565,263,2,4212,814,614,319,7597,933,4777,1077,616,36.69%,8.27%,5%,845,12172,6.49%,93.51%,11145,476,23,24,1,43,
0500000US21235,"Whitley County, Kentucky",36252,18290,50.45%,49.55%,50.6,3175,8.76%,1443,1668,348,8782,1279,2309,2304,18733,4613,10225,2947,2657,28.21%,8.13%,7%,687,36025,1.90%,98.10%,34076,531,89,204,10,50,
0500000US21237,"Wolfe County, Kentucky",7188,3559,49.51%,50.49%,47.8,1039,14.45%,261,94,19,1646,377,140,197,3499,337,1907,471,159,26.53%,6.55%,2%,61,6501,0.85%,99.15%,6356,27,9,5,0,15,
0500000US21239,"Woodford County, Kentucky",26486,13945,52.65%,47.35%,55.7,917,3.46%,835,919,201,5110,1445,4159,2592,16710,6751,5945,2364,4360,22.45%,8.93%,16%,2013,24858,7.60%,92.40%,22361,1211,28,157,10,76,
0500000US22001,"Acadia Parish, Louisiana",62371,31886,51.12%,48.88%,50.5,7517,12.05%,1868,1489,196,17622,2985,4323,1987,33525,6310,19490,4474,4519,31.25%,7.17%,7%,1641,55935,2.63%,97.37%,44115,9946,145,163,2,99,
0500000US22003,"Allen Parish, Louisiana",25572,11079,43.33%,56.68%,43.1,1291,5.05%,1056,269,135,7765,1077,1473,724,14640,2197,8821,1346,1608,34.49%,5.26%,6%,1893,20857,7.40%,92.60%,15146,4016,525,183,7,61,
0500000US22005,"Ascension Parish, Louisiana",125061,63361,50.66%,49.34%,55.5,6836,5.47%,4009,3678,944,24226,7667,15797,6645,72900,22442,28235,11345,16741,22.58%,9.07%,13%,10383,116117,8.30%,91.70%,79645,30296,266,1681,32,355,
0500000US22007,"Assumption Parish, Louisiana",22236,11582,52.09%,47.91%,50.8,1707,7.68%,766,476,94,6278,734,1522,468,11713,1990,7044,1210,1616,31.68%,5.44%,7%,914,20125,4.11%,95.89%,13580,5973,83,56,0,17,
0500000US22009,"Avoyelles Parish, Louisiana",40465,20124,49.73%,50.27%,42.7,3925,9.70%,1306,1089,74,10478,1697,2332,1073,21942,3405,11784,2786,2406,29.12%,6.88%,6%,1485,38208,3.67%,96.33%,25236,10649,349,345,3,106,
0500000US22011,"Beauregard Parish, Louisiana",37387,18344,49.07%,50.94%,48.5,2360,6.31%,1617,744,239,9228,2386,3027,1542,21743,4569,10845,3130,3266,29.01%,8.37%,9%,1271,35278,3.40%,96.60%,29039,4082,273,222,27,91,
0500000US22013,"Bienville Parish, Louisiana",13391,7108,53.08%,46.92%,40.8,2078,15.52%,398,402,79,4157,660,761,394,7882,1155,4555,1062,840,34.02%,7.93%,6%,211,12770,1.58%,98.42%,6901,5273,61,21,5,10,
0500000US22015,"Bossier Parish, Louisiana",126952,64337,50.68%,49.32%,50.4,8847,6.97%,4069,4879,945,23476,7652,13727,7663,75770,21390,27545,12531,14672,21.70%,9.87%,12%,10237,118509,8.06%,91.94%,78982,29868,573,2341,113,480,
0500000US22017,"Caddo Parish, Louisiana",243243,128060,52.65%,47.35%,39.6,21092,8.67%,6817,8067,1399,51806,11977,23751,16624,143259,40375,58623,20044,25150,24.10%,8.24%,10%,8381,229467,3.45%,96.55%,101727,114769,895,3179,120,856,
0500000US22019,"Calcasieu Parish, Louisiana",202858,103936,51.24%,48.76%,48,14617,7.21%,6241,7687,1632,45279,12140,19511,9930,117619,29441,51520,19827,21143,25.40%,9.77%,10%,11384,205401,5.61%,94.39%,137110,54825,902,3797,137,853,
0500000US22021,"Caldwell Parish, Louisiana",9959,4810,48.30%,51.70%,54.6,747,7.50%,374,241,0,3304,249,770,228,5549,998,3678,490,770,36.93%,4.92%,8%,221,9424,2.22%,97.78%,7551,1528,19,42,3,6,
0500000US22023,"Cameron Parish, Louisiana",6963,3533,50.74%,49.26%,61.7,184,2.64%,243,126,40,2043,323,573,259,4447,832,2286,449,613,32.83%,6.45%,9%,197,5420,2.83%,97.17%,5174,71,28,13,1,8,
0500000US22025,"Catahoula Parish, Louisiana",9586,4456,46.48%,53.52%,51.8,752,7.84%,288,225,23,2664,339,715,334,5095,1049,2952,564,738,30.79%,5.88%,8%,614,8292,6.41%,93.59%,5738,2275,34,26,6,10,
0500000US22027,"Claiborne Parish, Louisiana",15854,6757,42.62%,57.38%,35.9,1411,8.90%,603,264,46,5090,403,942,560,9299,1502,5693,667,988,35.91%,4.21%,6%,479,13691,3.02%,96.98%,7064,6138,43,42,0,21,
0500000US22029,"Concordia Parish, Louisiana",19533,9877,50.57%,49.43%,43.4,2330,11.93%,644,658,58,5269,804,1181,571,10592,1752,5913,1462,1239,30.27%,7.48%,6%,459,18228,2.35%,97.65%,10157,7477,39,115,0,16,
0500000US22031,"De Soto Parish, Louisiana",27395,14022,51.19%,48.82%,42.5,2780,10.15%,866,660,48,7954,1126,1826,832,15448,2658,8820,1786,1874,32.20%,6.52%,7%,762,26050,2.78%,97.22%,15122,9586,242,99,0,72,
0500000US22033,"East Baton Rouge Parish, Louisiana",443158,231321,52.20%,47.80%,39.3,35081,7.92%,15845,31385,7943,74090,15555,61214,41745,253751,102959,89935,46940,69157,20.29%,10.59%,16%,30551,426230,6.89%,93.11%,191355,205552,773,14388,106,1564,
0500000US22035,"East Carroll Parish, Louisiana",6947,2954,42.52%,57.48%,27,1224,17.62%,287,114,0,1777,142,268,132,3053,400,2064,256,268,29.71%,3.69%,4%,115,7344,1.66%,98.34%,2034,5164,2,17,0,5,
0500000US22037,"East Feliciana Parish, Louisiana",19228,8669,45.09%,54.92%,44.6,1353,7.04%,763,509,12,5943,950,1493,394,11351,1887,6706,1459,1505,34.88%,7.59%,8%,391,19148,2.03%,97.97%,11411,7108,60,46,9,42,
0500000US22039,"Evangeline Parish, Louisiana",33491,16235,48.48%,51.52%,41.6,3360,10.03%,1355,941,51,9267,1728,2070,760,17060,2830,10622,2669,2121,31.72%,7.97%,6%,1336,31014,3.99%,96.01%,21162,8609,45,183,2,91,
0500000US22041,"Franklin Parish, Louisiana",20109,10410,51.77%,48.23%,50.6,2816,14.00%,800,388,35,5561,736,1171,602,10236,1773,6361,1124,1206,31.63%,5.59%,6%,276,19498,1.37%,98.63%,12430,6508,26,38,0,17,
0500000US22043,"Grant Parish, Louisiana",22339,9710,43.47%,56.53%,42.8,1239,5.55%,942,258,196,6899,1530,1234,372,13433,1606,7841,1788,1430,35.10%,8.00%,6%,1333,20836,5.97%,94.03%,16678,3060,193,67,6,42,
0500000US22045,"Iberia Parish, Louisiana",70763,36016,50.90%,49.10%,47.7,7130,10.08%,2906,1778,89,19555,3174,5180,1907,37872,7087,22461,4952,5269,31.74%,7.00%,7%,3897,66032,5.51%,94.49%,38572,22984,247,1933,3,227,
0500000US22047,"Iberville Parish, Louisiana",32626,16184,49.61%,50.40%,38.6,1970,6.04%,957,985,167,9514,1602,2400,1310,18518,3710,10471,2587,2567,32.09%,7.93%,8%,1418,28823,4.35%,95.65%,14632,13313,58,123,13,75,
0500000US22049,"Jackson Parish, Louisiana",15822,7787,49.22%,50.78%,42.8,1369,8.65%,572,418,71,4810,907,1059,460,9329,1519,5382,1325,1130,34.02%,8.37%,7%,468,14563,2.96%,97.04%,9896,3945,34,146,5,23,
0500000US22051,"Jefferson Parish, Louisiana",434903,224599,51.64%,48.36%,43.9,28666,6.59%,11661,11516,4153,92509,18367,55501,28918,264327,84419,104170,29883,59654,23.95%,6.87%,14%,79057,361724,18.18%,81.82%,208385,115900,1317,19528,105,2379,
0500000US22053,"Jefferson Davis Parish, Louisiana",31425,16015,50.96%,49.04%,46.2,2650,8.43%,829,1321,85,8574,1180,2312,1540,17104,3852,9403,2501,2397,29.92%,7.96%,8%,734,31516,2.34%,97.66%,24855,5130,147,100,4,118,
0500000US22055,"Lafayette Parish, Louisiana",243692,125118,51.34%,48.66%,45.3,17758,7.29%,6869,11060,1758,48862,8893,37763,16434,145986,54197,55731,19953,39521,22.87%,8.19%,16%,15983,225770,6.56%,93.44%,150475,60677,716,5212,68,904,
0500000US22057,"Lafourche Parish, Louisiana",97980,50037,51.07%,48.93%,52.1,6241,6.37%,2940,3419,546,27917,3502,7628,3682,53600,11310,30857,6921,8174,31.49%,7.06%,8%,5672,91885,5.79%,94.21%,70722,14532,2427,759,31,160,
0500000US22059,"LaSalle Parish, Louisiana",14950,7174,47.99%,52.01%,49,802,5.36%,590,408,11,4406,668,1245,328,8058,1573,4996,1076,1256,33.42%,7.20%,8%,1402,13389,9.38%,90.62%,11263,1283,133,252,10,26,
0500000US22061,"Lincoln Parish, Louisiana",47118,24034,51.01%,48.99%,33.8,7235,15.36%,2061,7978,1121,7143,1566,5380,3671,22854,9051,9204,9544,6501,19.53%,20.26%,14%,1754,46642,3.72%,96.28%,25672,18626,145,682,5,106,
0500000US22063,"Livingston Parish, Louisiana",140524,71461,50.85%,49.15%,49.2,6507,4.63%,5066,4039,584,36968,5993,12670,5610,81272,18280,42034,10032,13254,29.91%,7.14%,9%,8791,133491,6.26%,93.74%,114876,11178,365,1116,36,361,
0500000US22065,"Madison Parish, Louisiana",11137,5667,50.88%,49.12%,33.3,1536,13.79%,334,198,21,2448,304,754,378,5640,1132,2782,502,775,24.98%,4.51%,7%,204,9813,1.83%,98.17%,3414,6173,27,6,5,4,
0500000US22067,"Morehouse Parish, Louisiana",25189,13062,51.86%,48.14%,41.5,2697,10.71%,1012,564,122,6945,1327,1736,401,13930,2137,7957,1891,1858,31.59%,7.51%,7%,381,25248,1.51%,98.49%,12220,11976,80,89,3,29,
0500000US22069,"Natchitoches Parish, Louisiana",38505,19960,51.84%,48.16%,36,6755,17.54%,4005,1730,220,8761,2954,2760,1831,20252,4591,12766,4684,2980,33.15%,12.16%,8%,1490,36025,3.87%,96.13%,18898,14857,284,166,19,301,
0500000US22071,"Orleans Parish, Louisiana",391249,205997,52.65%,47.35%,28.5,42114,10.76%,8957,16868,3704,63530,15211,58673,47403,244889,106076,72487,32079,62377,18.53%,8.20%,16%,31017,352980,7.93%,92.07%,121385,205876,761,10573,125,2075,
0500000US22073,"Ouachita Parish, Louisiana",154679,80595,52.11%,47.90%,42.2,16710,10.80%,3961,7309,1439,34922,5416,15726,9626,88780,25352,38883,12725,17165,25.14%,8.23%,11%,5658,154710,3.66%,96.34%,87426,58804,413,2276,30,408,
0500000US22075,"Plaquemines Parish, Louisiana",23305,11929,51.19%,48.81%,52.9,2018,8.66%,523,778,166,5399,1070,2052,756,13120,2808,5922,1848,2218,25.41%,7.93%,10%,2236,21279,9.59%,90.41%,13764,4863,255,1042,40,191,
0500000US22077,"Pointe Coupee Parish, Louisiana",21883,11260,51.46%,48.55%,43.2,2068,9.45%,593,822,0,5924,1058,1648,675,12362,2323,6517,1880,1648,29.78%,8.59%,8%,625,20133,2.86%,97.14%,12245,7221,37,60,2,57,
0500000US22079,"Rapides Parish, Louisiana",130376,67347,51.66%,48.34%,43.1,9837,7.55%,4517,4277,599,31478,5228,11542,7262,74999,18804,35995,9505,12141,27.61%,7.29%,9%,5090,124933,3.90%,96.10%,76323,40261,901,1805,33,459,
0500000US22081,"Red River Parish, Louisiana",8462,4311,50.95%,49.06%,43.8,1255,14.83%,368,214,14,2655,202,377,385,4596,762,3023,416,391,35.72%,4.92%,5%,188,7432,2.22%,97.78%,4150,2952,41,0,0,20,
0500000US22083,"Richland Parish, Louisiana",20251,10355,51.13%,48.87%,43,2577,12.73%,830,441,31,5257,640,1099,1065,10747,2164,6087,1081,1130,30.06%,5.34%,6%,400,19643,1.98%,98.02%,11667,7303,53,50,0,66,
0500000US22085,"Sabine Parish, Louisiana",23915,12092,50.56%,49.44%,45.4,2375,9.93%,1035,329,105,7841,1110,1475,694,14139,2169,8876,1439,1580,37.11%,6.02%,7%,710,21445,2.97%,97.03%,14850,3520,1790,63,12,69,
0500000US22087,"St. Bernard Parish, Louisiana",46694,23883,51.15%,48.85%,38.8,4868,10.43%,1209,1442,187,9864,2220,3050,1222,24745,4272,11073,3662,3237,23.71%,7.84%,7%,6010,37754,12.87%,87.13%,23165,11370,215,972,6,285,
0500000US22089,"St. Charles Parish, Louisiana",52856,26678,50.47%,49.53%,51.1,2525,4.78%,1686,1496,595,11501,2919,7571,2479,31881,10050,13187,4415,8166,24.95%,8.35%,15%,4141,48408,7.83%,92.17%,32708,13024,215,555,20,172,
0500000US22091,"St. Helena Parish, Louisiana",10227,5326,52.08%,47.92%,46.5,1036,10.13%,404,297,4,2918,512,678,513,5720,1191,3322,809,682,32.48%,7.91%,7%,216,10704,2.11%,97.89%,4494,5846,38,19,4,23,
0500000US22093,"St. James Parish, Louisiana",21142,11058,52.30%,47.70%,49.6,1183,5.60%,681,759,116,5916,1257,1634,822,12517,2456,6597,2016,1750,31.20%,9.54%,8%,343,19849,1.62%,98.38%,9917,9486,28,28,0,28,
0500000US22095,"St. John the Baptist Parish, Louisiana",43055,22156,51.46%,48.54%,43.9,3480,8.08%,1279,1255,426,10185,2292,3242,1697,24584,4939,11464,3547,3668,26.63%,8.24%,9%,3291,39186,7.64%,92.36%,13348,24076,105,314,7,140,
0500000US22097,"St. Landry Parish, Louisiana",82786,42834,51.74%,48.26%,45.9,9573,11.56%,2837,1987,111,21062,3586,5095,3016,41139,8111,23899,5573,5206,28.87%,6.73%,6%,2178,80362,2.63%,97.37%,43225,34218,153,374,12,282,
0500000US22099,"St. Martin Parish, Louisiana",53607,27253,50.84%,49.16%,46.1,3982,7.43%,1843,1336,269,16260,2195,4167,1248,30093,5415,18103,3531,4436,33.77%,6.59%,8%,1679,50088,3.13%,96.87%,32919,15050,177,440,3,170,
0500000US22101,"St. Mary Parish, Louisiana",50020,25337,50.65%,49.35%,37.6,4377,8.75%,1730,1035,307,17408,2135,2266,1073,27966,3339,19138,3170,2573,38.26%,6.34%,5%,4524,44882,9.04%,90.96%,26334,14950,911,647,13,179,
0500000US22103,"St. Tammany Parish, Louisiana",258447,132943,51.44%,48.56%,52.3,11409,4.41%,6477,7302,2083,44626,13151,39396,21337,160337,60733,51103,20453,41479,19.77%,7.91%,16%,20844,243726,8.07%,91.93%,192144,33969,876,3814,105,1352,
0500000US22105,"Tangipahoa Parish, Louisiana",133753,69035,51.61%,48.39%,44.4,11621,8.69%,4521,6225,775,30593,5170,13534,5644,71685,19178,35114,11395,14309,26.25%,8.52%,11%,7242,125915,5.41%,94.59%,79825,39770,409,942,23,376,
0500000US22107,"Tensas Parish, Louisiana",4435,2291,51.66%,48.34%,44.4,778,17.54%,110,73,17,1249,54,469,125,2473,594,1359,127,486,30.64%,2.86%,11%,67,4080,1.51%,98.49%,1728,2232,0,6,1,11,
0500000US22109,"Terrebonne Parish, Louisiana",111297,56489,50.76%,49.25%,46.7,8760,7.87%,3151,3040,640,28763,4235,7861,3830,59681,11691,31914,7275,8501,28.67%,6.54%,8%,7358,102222,6.61%,93.39%,68802,21059,5808,1294,39,299,
0500000US22111,"Union Parish, Louisiana",22270,11143,50.04%,49.96%,47.1,2511,11.28%,589,636,0,7083,728,2000,703,13523,2703,7672,1364,2000,34.45%,6.12%,9%,1135,19972,5.10%,94.90%,14289,4980,59,38,6,30,
0500000US22113,"Vermilion Parish, Louisiana",59787,30750,51.43%,48.57%,51.9,4932,8.25%,2288,1344,247,16499,2545,4759,1688,31853,6447,18787,3889,5006,31.42%,6.50%,8%,2296,55063,3.84%,96.16%,44020,7859,171,1253,9,170,
0500000US22115,"Vernon Parish, Louisiana",49315,23138,46.92%,53.08%,53.5,3298,6.69%,3830,2208,420,11683,2340,3903,1451,26316,5354,15513,4548,4323,31.46%,9.22%,9%,4175,44575,8.47%,91.53%,33599,6325,484,862,289,274,
0500000US22117,"Washington Parish, Louisiana",46325,23409,50.53%,49.47%,43.8,4207,9.08%,1881,1097,212,13485,1752,2570,1158,25465,3728,15366,2849,2782,33.17%,6.15%,6%,1410,44053,3.04%,96.96%,29588,12758,134,161,0,80,
0500000US22119,"Webster Parish, Louisiana",38813,19816,51.06%,48.95%,46.5,3153,8.12%,1318,1148,178,11422,2032,2788,1250,23087,4038,12740,3180,2966,32.82%,8.19%,8%,688,36279,1.77%,98.23%,22554,12142,136,138,12,76,
0500000US22121,"West Baton Rouge Parish, Louisiana",26395,13548,51.33%,48.67%,50.8,1348,5.11%,635,755,134,6561,1144,2509,1578,15650,4087,7196,1899,2643,27.26%,7.19%,10%,1244,25955,4.71%,95.29%,14114,10714,59,219,8,70,
0500000US22123,"West Carroll Parish, Louisiana",10934,5282,48.31%,51.69%,48.7,904,8.27%,266,300,9,3683,296,497,381,6159,878,3949,596,506,36.12%,5.45%,5%,325,9426,2.97%,97.03%,7799,1338,37,13,0,0,
0500000US22125,"West Feliciana Parish, Louisiana",15441,5143,33.31%,66.69%,33.5,395,2.56%,412,328,84,3792,413,2066,742,9573,2808,4204,741,2150,27.23%,4.80%,14%,651,14659,4.22%,95.78%,10585,3589,95,30,5,32,
0500000US22127,"Winn Parish, Louisiana",14165,6601,46.60%,53.40%,42.4,979,6.91%,477,312,46,4209,752,1282,417,8216,1699,4686,1064,1328,33.08%,7.51%,9%,1023,12732,7.22%,92.78%,8498,3518,77,172,16,25,
0500000US23001,"Androscoggin County, Maine",107958,55120,51.06%,48.94%,48.6,4143,3.84%,3601,3816,942,26755,8873,11463,5634,68671,17097,30356,12689,12405,28.12%,11.75%,11%,2222,108917,2.06%,97.94%,95875,6436,382,895,50,376,
0500000US23003,"Aroostook County, Maine",67431,34038,50.48%,49.52%,52.2,3482,5.16%,1710,2191,399,18616,5986,6831,3066,44960,9897,20326,8177,7230,30.14%,12.13%,11%,912,66193,1.35%,98.65%,62163,423,1206,392,18,131,
0500000US23005,"Cumberland County, Maine",294520,151568,51.46%,48.54%,49.7,9795,3.33%,6774,11879,4686,46308,18384,62249,40667,204063,102916,53082,30263,66935,18.02%,10.28%,23%,8011,295058,2.72%,97.28%,262137,11925,667,7167,96,1169,
0500000US23007,"Franklin County, Maine",29933,15322,51.19%,48.81%,50.8,1249,4.17%,951,1458,251,8424,2155,3533,2194,20374,5727,9375,3613,3784,31.32%,12.07%,13%,407,29049,1.36%,98.64%,27211,166,73,383,23,109,
0500000US23009,"Hancock County, Maine",54832,28332,51.67%,48.33%,53.2,2387,4.35%,1241,1618,435,13271,3762,8952,5834,39812,14786,14512,5380,9387,26.47%,9.81%,17%,969,54509,1.77%,98.23%,51098,351,231,560,10,219,
0500000US23011,"Kennebec County, Maine",122158,62559,51.21%,48.79%,49.3,5775,4.73%,3206,4388,1244,29472,9410,15694,10210,82357,25904,32678,13798,16938,26.75%,11.30%,14%,2552,121090,2.09%,97.91%,112682,850,460,1215,29,385,
0500000US23013,"Knox County, Maine",39809,19901,49.99%,50.01%,51.8,1566,3.93%,1137,1057,83,9628,2480,6566,3768,28105,10334,10765,3537,6649,27.04%,8.88%,17%,672,39935,1.69%,98.31%,37533,256,139,250,18,144,
0500000US23015,"Lincoln County, Maine",34415,17544,50.98%,49.02%,53.4,1441,4.19%,1010,589,259,8738,2196,5454,4105,24811,9559,9748,2785,5713,28.32%,8.09%,17%,395,34842,1.15%,98.85%,33071,156,105,227,9,97,
0500000US23017,"Oxford County, Maine",57741,29258,50.67%,49.33%,50.1,2921,5.06%,1647,1207,338,17744,5055,6037,2895,39569,8932,19391,6262,6375,33.58%,10.84%,11%,865,56912,1.50%,98.50%,53456,209,187,275,16,157,
0500000US23019,"Penobscot County, Maine",151696,76463,50.41%,49.60%,47.6,8214,5.41%,4609,8613,1490,36200,11838,19119,11835,100591,30954,40809,20451,20609,26.90%,13.48%,14%,2715,149484,1.79%,98.21%,138306,1443,1349,1853,37,420,
0500000US23021,"Piscataquis County, Maine",16864,8397,49.79%,50.21%,48.7,1153,6.84%,392,352,83,5394,1541,1731,699,11899,2430,5786,1893,1814,34.31%,11.23%,11%,261,16539,1.55%,98.45%,15474,57,102,120,7,66,
0500000US23023,"Sagadahoc County, Maine",35720,18226,51.03%,48.98%,57.9,1382,3.87%,840,888,129,8185,2435,5851,4197,25413,10048,9025,3323,5980,25.27%,9.30%,17%,649,36050,1.82%,98.18%,33830,295,92,247,3,116,
0500000US23025,"Somerset County, Maine",50573,25511,50.44%,49.56%,49.4,3046,6.02%,1078,1449,252,15555,4611,5046,1693,33943,6739,16633,6060,5298,32.89%,11.98%,10%,656,49821,1.30%,98.70%,46914,248,213,261,14,140,
0500000US23027,"Waldo County, Maine",39723,20262,51.01%,48.99%,54.8,1841,4.63%,1141,984,388,9375,2635,6014,3291,27361,9305,10516,3619,6402,26.47%,9.11%,16%,559,39048,1.41%,98.59%,36883,135,140,200,12,134,
0500000US23029,"Washington County, Maine",31378,15986,50.95%,49.05%,52.2,1959,6.24%,933,918,98,8777,2051,3447,2058,21021,5505,9710,2969,3545,30.95%,9.46%,11%,667,30428,2.13%,97.87%,27587,156,1381,121,7,86,
0500000US23031,"York County, Maine",206074,105710,51.30%,48.70%,53.2,5715,2.77%,5707,5472,2247,45015,16990,31759,17283,142910,49042,50722,22462,34006,24.61%,10.90%,17%,4097,207875,1.99%,98.01%,194044,2009,566,2502,58,681,
0500000US24001,"Allegany County, Maryland",71002,33673,47.43%,52.58%,43.1,4508,6.35%,2919,4594,685,20193,4762,5695,3940,44743,9635,23112,9356,6380,32.55%,13.18%,9%,1149,66957,1.62%,98.38%,57953,5286,115,733,22,185,
0500000US24003,"Anne Arundel County, Maryland",575421,290739,50.53%,49.47%,52.1,16090,2.80%,17738,20629,6645,90238,30097,98301,72587,370408,170888,107976,50726,104946,18.76%,8.82%,18%,56796,531465,9.87%,90.13%,367893,102555,1178,25187,411,3118,
0500000US24005,"Baltimore County, Maryland",828193,436026,52.65%,47.35%,45.6,37715,4.55%,23371,32545,10072,145165,41935,131027,97986,527530,229013,168536,74480,141099,20.35%,8.99%,17%,61492,793043,7.42%,92.58%,443263,252724,1942,54701,252,4461,
0500000US24009,"Calvert County, Maryland",92094,46443,50.43%,49.57%,54.8,2098,2.28%,2508,3370,1039,18397,5196,11834,9787,59610,21621,20905,8566,12873,22.70%,9.30%,14%,4202,88581,4.56%,95.44%,68760,11922,207,1549,74,406,
0500000US24011,"Caroline County, Maryland",33260,16948,50.96%,49.04%,50.1,1787,5.37%,1281,881,180,8914,1652,2583,1724,19146,4307,10195,2533,2763,30.65%,7.62%,8%,2820,30473,8.48%,91.52%,24114,4368,67,345,13,102,
0500000US24013,"Carroll County, Maryland",168233,84960,50.50%,49.50%,58.2,3675,2.18%,4540,6104,2386,33707,9407,26981,16329,109167,43310,38247,15511,29367,22.73%,9.22%,17%,7745,165146,4.60%,95.40%,146701,6361,268,3766,36,601,
0500000US24015,"Cecil County, Maryland",102889,51704,50.25%,49.75%,51.9,4922,4.78%,3748,2750,867,25138,5390,10932,7103,64257,18035,28886,8140,11799,28.07%,7.91%,11%,5450,98275,5.30%,94.70%,83485,7500,231,1232,23,408,
0500000US24017,"Charles County, Maryland",161448,83692,51.84%,48.16%,49.4,5888,3.65%,5473,5887,1266,33804,9237,19169,13449,101743,32618,39277,15124,20435,24.33%,9.37%,13%,11677,154940,7.23%,92.77%,56832,80850,995,5624,147,957,
0500000US24019,"Dorchester County, Maryland",31994,17044,53.27%,46.73%,47.5,2263,7.07%,823,800,237,8873,1551,2693,1902,20114,4595,9696,2351,2930,30.31%,7.35%,9%,1777,30754,5.55%,94.45%,19891,9017,91,355,6,130,
0500000US24021,"Frederick County, Maryland",255955,129935,50.77%,49.24%,55,7640,2.98%,6971,9575,2915,41545,14830,40541,32257,161663,72798,48516,24405,43456,18.95%,9.53%,17%,32119,239598,12.55%,87.45%,183636,27007,401,13427,154,1445,
0500000US24023,"Garrett County, Maryland",29155,14632,50.19%,49.81%,54.8,1411,4.84%,786,988,24,9192,1792,2926,2130,19412,5056,9978,2780,2950,34.22%,9.54%,10%,321,28485,1.10%,98.90%,27402,239,33,82,2,54,
0500000US24025,"Harford County, Maryland",253736,129671,51.11%,48.90%,55.4,10015,3.95%,7442,8102,2562,45907,14924,37733,27393,164270,65126,53349,23026,40295,21.03%,9.07%,16%,14007,246917,5.52%,94.48%,186984,36837,442,8094,178,1211,
0500000US24027,"Howard County, Maryland",322407,164747,51.10%,48.90%,56.7,8224,2.55%,7133,10377,5670,29137,11731,66306,70486,208467,136792,36270,22108,71976,11.25%,6.86%,22%,27362,304955,8.49%,91.51%,155236,64018,461,66073,114,2213,
0500000US24029,"Kent County, Maryland",19456,10223,52.54%,47.46%,47,851,4.37%,741,1441,138,4341,833,2937,2113,12422,5050,5082,2274,3075,26.12%,11.69%,16%,1061,18137,5.45%,94.55%,14384,2751,24,250,0,62,
0500000US24031,"Montgomery County, Maryland",1047661,541193,51.66%,48.34%,53.6,31836,3.04%,21210,30772,19797,96619,40251,197098,230869,659891,427967,117829,71023,216895,11.25%,6.78%,21%,217409,844652,20.75%,79.25%,430980,192714,1377,162472,440,8589,
0500000US24033,"Prince George's County, Maryland",910551,472501,51.89%,48.11%,39.5,37611,4.13%,24497,41663,10620,156826,39413,118752,94404,540348,213156,181323,81076,129372,19.91%,8.90%,14%,205463,761738,22.56%,77.44%,109060,571866,1887,41436,335,5746,
0500000US24035,"Queen Anne's County, Maryland",50163,25205,50.25%,49.75%,58,1559,3.11%,1319,1349,632,10380,2919,7708,5345,33353,13053,11699,4268,8340,23.32%,8.51%,17%,2538,47336,5.06%,94.94%,41782,2775,63,587,11,190,
0500000US24037,"St. Mary's County, Maryland",113182,56632,50.04%,49.96%,51.8,4226,3.73%,3923,4047,1416,22962,6289,13957,10150,67976,24107,26885,10336,15373,23.75%,9.13%,14%,6545,107232,5.78%,94.22%,80233,15994,318,3301,86,533,
0500000US24039,"Somerset County, Maryland",25699,11858,46.14%,53.86%,39.4,1579,6.14%,686,2758,174,6355,1322,1853,850,14321,2703,7041,4080,2027,27.40%,15.88%,8%,1075,23545,4.18%,95.82%,12886,9449,80,250,1,69,
0500000US24041,"Talbot County, Maryland",37087,19517,52.63%,47.38%,54.8,1362,3.67%,978,910,107,6484,2318,5957,5177,25557,11134,7462,3228,6064,20.12%,8.70%,16%,3352,34174,9.04%,90.96%,28065,4186,45,536,11,162,
0500000US24043,"Washington County, Maryland",150575,73965,49.12%,50.88%,48.2,6397,4.25%,5058,4129,1122,37995,8219,13986,9651,93091,23637,43053,12348,15108,28.59%,8.20%,10%,10289,144416,6.83%,93.17%,115223,17241,253,3083,63,731,
0500000US24045,"Wicomico County, Maryland",103222,54191,52.50%,47.50%,39.5,8216,7.96%,4160,8668,1081,21554,4757,10619,7639,57163,18258,25714,13425,11700,24.91%,13.01%,11%,7091,96497,6.87%,93.13%,60340,27586,212,3120,39,443,
0500000US24047,"Worcester County, Maryland",51967,26595,51.18%,48.82%,53.4,2496,4.80%,965,1687,283,12216,3294,7399,4405,36542,11804,13181,4981,7682,25.36%,9.58%,15%,2078,50382,4.00%,96.00%,41383,6166,87,739,5,166,
0500000US24510,"Baltimore city, Maryland",602274,319886,53.11%,46.89%,26.6,59344,9.85%,16219,25228,7968,120066,20779,70536,67979,360476,138515,136285,46007,78504,22.63%,7.64%,13%,45927,539781,7.63%,92.37%,157296,335615,1278,21020,152,3332,
0500000US25001,"Barnstable County, Massachusetts",213505,111324,52.14%,47.86%,54.4,6216,2.91%,5008,5134,2824,37765,16075,41502,33450,159551,74952,42773,21209,44326,20.03%,9.93%,21%,7908,221088,3.70%,96.30%,194561,6409,1092,3183,65,3448,
0500000US25003,"Berkshire County, Massachusetts",125927,64914,51.55%,48.45%,45.4,5863,4.66%,3390,6201,1155,27669,8295,17923,14812,86081,32735,31059,14496,19078,24.66%,11.51%,15%,7064,121962,5.61%,94.39%,109263,4064,165,1999,18,632,
0500000US25005,"Bristol County, Massachusetts",563301,290639,51.60%,48.40%,46.1,27306,4.85%,18257,20117,6343,119795,36850,74178,41341,341086,115519,138052,56967,80521,24.51%,10.11%,14%,54751,524449,9.72%,90.28%,445658,23123,938,13651,102,8730,
0500000US25007,"Dukes County, Massachusetts",17430,8938,51.28%,48.72%,49.4,742,4.26%,280,535,121,3115,1168,3236,2621,12736,5857,3395,1703,3357,19.48%,9.77%,19%,534,20066,3.06%,96.94%,16230,795,202,184,9,701,
0500000US25009,"Essex County, Massachusetts",787038,407787,51.81%,48.19%,47.7,34744,4.41%,22524,28294,12044,134152,44973,132915,89588,490914,222503,156676,73267,144959,19.91%,9.31%,18%,182847,626982,23.23%,76.77%,536424,27081,782,29302,130,6788,
0500000US25011,"Franklin County, Massachusetts",70529,36192,51.32%,48.69%,47.5,2685,3.81%,1915,1764,698,14961,5494,10905,9551,49934,20456,16876,7258,11603,23.93%,10.29%,16%,3592,67437,5.09%,94.91%,61464,963,121,1186,10,362,
0500000US25013,"Hampden County, Massachusetts",466647,241234,51.70%,48.31%,41.6,30119,6.45%,14913,22159,3769,95698,30431,53400,34033,273279,87433,110611,52590,57169,23.70%,11.27%,12%,121319,344506,26.00%,74.00%,278464,35988,659,12110,169,1945,
0500000US25015,"Hampshire County, Massachusetts",161361,86078,53.35%,46.66%,40.5,7982,4.95%,4608,28804,3042,22656,8998,24371,24581,95159,48952,27264,37802,27413,16.90%,23.43%,17%,11622,150686,7.20%,92.80%,127578,4360,205,10740,56,723,
0500000US25017,"Middlesex County, Massachusetts",1605899,819338,51.02%,48.98%,50,52960,3.30%,42142,59769,42410,209181,66767,317752,326957,1058146,644709,251323,126536,360162,15.65%,7.88%,22%,143245,1488757,8.92%,91.08%,1085919,80996,1414,209632,353,28194,
0500000US25019,"Nantucket County, Massachusetts",11212,5138,45.83%,54.17%,50.8,429,3.83%,197,132,174,1531,859,2645,1567,8430,4212,1728,991,2819,15.41%,8.84%,25%,2312,11943,20.62%,79.38%,9889,1006,19,263,2,149,
0500000US25021,"Norfolk County, Massachusetts",703740,364968,51.86%,48.14%,52.7,20955,2.98%,17196,21613,16517,92752,36112,142423,127721,465846,270144,109948,57725,158940,15.62%,8.20%,23%,38110,687871,5.42%,94.58%,512421,49311,701,88240,142,7344,
0500000US25023,"Plymouth County, Massachusetts",518597,266636,51.42%,48.59%,51.2,15716,3.03%,14111,17937,6913,99967,35232,87404,50962,336986,138366,114078,53169,94317,22.00%,10.25%,18%,23952,506867,4.62%,95.38%,406919,43482,796,7693,94,11966,
0500000US25025,"Suffolk County, Massachusetts",801162,414606,51.75%,48.25%,32,64875,8.10%,21287,56380,24031,117418,26935,146876,119317,484872,266193,138705,83315,170907,17.31%,10.40%,21%,178527,619409,22.28%,77.72%,352900,135255,1147,80607,281,11702,
0500000US25027,"Worcester County, Massachusetts",826655,419219,50.71%,49.29%,47.9,36028,4.36%,26392,33199,12510,156698,51588,125923,86188,522517,212111,183090,84787,138433,22.15%,10.26%,17%,111902,750209,13.54%,86.46%,611207,44222,1146,46110,176,9424,
0500000US26001,"Alcona County, Michigan",10396,5145,49.49%,50.51%,57.8,682,6.56%,166,152,8,3346,781,1018,562,7735,1580,3512,933,1026,33.78%,8.97%,10%,122,10045,1.17%,98.83%,9593,23,57,14,1,27,
0500000US26003,"Alger County, Michigan",9098,4015,44.13%,55.87%,46.5,340,3.74%,372,146,34,3329,469,941,411,6459,1352,3701,615,975,40.68%,6.76%,11%,115,8727,1.26%,98.74%,7323,585,327,22,1,25,
0500000US26005,"Allegan County, Michigan",117104,58637,50.07%,49.93%,57.5,5041,4.30%,4135,2591,815,29398,6844,12465,6317,72744,18782,33533,9435,13280,28.64%,8.06%,11%,9389,111113,8.02%,91.98%,103088,1446,561,839,20,433,
0500000US26007,"Alpena County, Michigan",28431,14358,50.50%,49.50%,50.6,1534,5.40%,590,918,71,7387,2880,2448,1349,19644,3797,7977,3798,2519,28.06%,13.36%,9%,417,28490,1.47%,98.53%,27006,99,120,112,12,67,
0500000US26009,"Antrim County, Michigan",23301,11747,50.41%,49.59%,60.9,987,4.24%,607,498,130,5420,1772,3291,1900,16330,5191,6027,2270,3421,25.87%,9.74%,15%,459,22972,1.97%,98.03%,21743,39,192,70,18,55,
0500000US26011,"Arenac County, Michigan",15013,7413,49.38%,50.62%,54.1,682,4.54%,421,322,12,4552,1326,969,497,10115,1466,4973,1648,981,33.12%,10.98%,7%,270,14732,1.80%,98.20%,13919,35,126,38,1,25,
0500000US26013,"Baraga County, Michigan",8337,3719,44.61%,55.39%,48.8,521,6.25%,325,122,62,2521,625,582,358,5572,940,2846,747,644,34.14%,8.96%,8%,102,8056,1.22%,98.78%,5753,598,1083,15,3,22,
0500000US26015,"Barry County, Michigan",61045,30440,49.87%,50.14%,58.1,2376,3.89%,2109,1575,308,15984,4062,6828,3030,39999,9858,18093,5637,7136,29.64%,9.23%,12%,2142,60281,3.51%,96.49%,56779,295,221,245,15,198,
0500000US26017,"Bay County, Michigan",103506,52473,50.70%,49.30%,48,7078,6.84%,2923,3085,516,25774,8314,9978,4744,67766,14722,28697,11399,10494,27.72%,11.01%,10%,5930,97926,5.73%,94.27%,90811,1598,359,538,0,257,
0500000US26019,"Benzie County, Michigan",17703,8967,50.65%,49.35%,54.9,520,2.94%,402,440,122,3913,1458,2791,1554,12559,4345,4315,1898,2913,24.37%,10.72%,16%,391,17579,2.21%,97.79%,16597,56,164,71,0,65,
0500000US26021,"Berrien County, Michigan",153797,78480,51.03%,48.97%,50.1,11041,7.18%,4245,4996,1078,30731,10810,17936,11771,97546,29707,34976,15806,19014,22.74%,10.28%,12%,9210,145106,5.99%,94.01%,111603,21199,740,3159,109,668,
0500000US26023,"Branch County, Michigan",43428,21120,48.63%,51.37%,50.1,2634,6.07%,1251,1081,115,12408,2520,3181,1333,26848,4514,13659,3601,3296,31.45%,8.29%,8%,2583,42279,5.95%,94.05%,39025,1124,132,266,10,135,
0500000US26025,"Calhoun County, Michigan",133943,68248,50.95%,49.05%,45.1,7837,5.85%,4182,5534,579,32646,8426,12613,6973,82860,19586,36828,13960,13192,27.50%,10.42%,10%,7426,126884,5.54%,94.46%,100385,14275,683,3715,29,553,
0500000US26027,"Cass County, Michigan",51613,25759,49.91%,50.09%,55.3,3201,6.20%,1589,1491,202,12072,4094,5078,2587,32682,7665,13661,5585,5280,26.47%,10.82%,10%,2161,49428,4.19%,95.81%,43309,2272,521,316,11,218,
0500000US26029,"Charlevoix County, Michigan",26197,13238,50.53%,49.47%,58.5,1084,4.14%,600,947,93,5443,1935,3738,2536,18190,6274,6043,2882,3831,23.07%,11.00%,15%,425,25629,1.62%,98.38%,23881,74,367,122,10,114,
0500000US26031,"Cheboygan County, Michigan",25435,12673,49.83%,50.18%,55.5,1364,5.36%,617,658,122,6990,1725,2596,1675,17634,4271,7607,2383,2718,29.91%,9.37%,11%,341,25238,1.34%,98.66%,22872,89,687,85,1,65,
0500000US26033,"Chippewa County, Michigan",37418,17225,46.03%,53.97%,44.1,2772,7.41%,1338,2174,393,8677,2294,3934,1979,24090,5913,10015,4468,4327,26.77%,11.94%,12%,757,36028,2.02%,97.98%,24544,2611,5601,193,12,87,
0500000US26035,"Clare County, Michigan",30655,15360,50.11%,49.89%,51.2,2201,7.18%,686,776,74,8607,2003,1669,1063,19262,2732,9293,2779,1743,30.31%,9.07%,6%,621,30235,2.03%,97.97%,28628,140,181,72,0,88,
0500000US26037,"Clinton County, Michigan",78957,39828,50.44%,49.56%,54.4,3580,4.53%,2221,3119,803,14609,6671,11057,6441,51880,17498,16830,9790,11860,21.32%,12.40%,15%,3940,75188,4.99%,95.01%,67915,1640,234,1870,23,241,
0500000US26039,"Crawford County, Michigan",13904,6808,48.96%,51.04%,56.6,895,6.44%,378,266,79,3367,1182,1194,816,9516,2010,3745,1448,1273,26.93%,10.41%,9%,292,12696,2.10%,97.90%,12026,57,83,55,4,29,
0500000US26041,"Delta County, Michigan",35874,17859,49.78%,50.22%,55.8,1968,5.49%,867,898,150,9211,3813,3513,1566,24432,5079,10078,4711,3663,28.09%,13.13%,10%,543,36360,1.51%,98.49%,33441,93,818,153,8,82,
0500000US26043,"Dickinson County, Michigan",25373,12701,50.06%,49.94%,54.5,1084,4.27%,715,695,97,6198,2470,3032,1523,17675,4555,6913,3165,3129,27.25%,12.47%,12%,440,25507,1.73%,98.27%,24198,61,117,147,4,43,
0500000US26045,"Eaton County, Michigan",109730,55773,50.83%,49.17%,52.1,3979,3.63%,2883,4353,1040,20684,8608,14930,7617,73125,22547,23567,12961,15970,21.48%,11.81%,15%,6527,102648,5.95%,94.05%,87200,7463,307,2444,13,346,
0500000US26047,"Emmet County, Michigan",33175,16711,50.37%,49.63%,55.6,1392,4.20%,837,1283,183,6098,2689,4975,3441,22967,8416,6935,3972,5158,20.90%,11.97%,16%,592,33520,1.78%,98.22%,30359,159,1074,173,22,97,
0500000US26049,"Genesee County, Michigan",406770,210621,51.78%,48.22%,44.8,32527,8.00%,12683,13645,2530,89294,30208,38016,22148,254564,60164,101977,43853,40546,25.07%,10.78%,10%,16259,389952,4.00%,96.00%,283483,79080,1391,4041,116,1390,
0500000US26051,"Gladwin County, Michigan",25312,12623,49.87%,50.13%,55.9,1435,5.67%,666,460,135,7425,1824,1686,1017,16579,2703,8091,2284,1821,31.97%,9.02%,7%,482,24904,1.90%,98.10%,23830,68,95,72,0,45,
0500000US26053,"Gogebic County, Michigan",14715,6936,47.14%,52.86%,47,884,6.01%,397,433,41,3938,1687,1494,756,10676,2250,4335,2120,1535,29.46%,14.41%,10%,222,14158,1.51%,98.49%,12981,65,512,35,3,36,
0500000US26055,"Grand Traverse County, Michigan",92640,46902,50.63%,49.37%,51.8,3934,4.25%,1746,3310,752,15022,6762,15858,9882,63892,25740,16768,10072,16610,18.10%,10.87%,18%,3010,92228,3.25%,96.75%,85543,583,878,813,41,289,
0500000US26057,"Gratiot County, Michigan",40692,18889,46.42%,53.58%,46.9,2544,6.25%,1296,2342,335,11384,2633,3209,1455,25989,4664,12680,4975,3544,31.16%,12.23%,9%,3153,38608,7.75%,92.25%,34812,2195,156,161,28,96,
0500000US26059,"Hillsdale County, Michigan",45707,22908,50.12%,49.88%,52.5,2833,6.20%,1474,2087,228,12268,2659,3522,2420,28206,5942,13742,4746,3750,30.07%,10.38%,8%,1172,44574,2.56%,97.44%,42145,196,143,176,6,137,
0500000US26061,"Houghton County, Michigan",35890,16458,45.86%,54.14%,42.7,3462,9.65%,1616,4615,941,6460,1909,3991,3107,19602,7098,8076,6524,4932,22.50%,18.18%,14%,669,36692,1.86%,98.14%,33854,280,159,855,21,151,
0500000US26063,"Huron County, Michigan",31105,15653,50.32%,49.68%,54.4,1432,4.60%,924,771,144,9652,2594,2425,1258,20792,3683,10576,3365,2569,34.00%,10.82%,8%,840,30567,2.70%,97.30%,29508,77,77,150,5,42,
0500000US26065,"Ingham County, Michigan",290923,149087,51.25%,48.75%,39,24623,8.46%,13245,32100,7228,39088,15656,37274,32491,166134,69765,52333,47756,44502,17.99%,16.42%,15%,24422,260478,8.39%,91.61%,191551,34446,953,16424,110,1451,
0500000US26067,"Ionia County, Michigan",64401,29700,46.12%,53.88%,50.1,2268,3.52%,2490,2395,291,17056,4522,5376,2092,40086,7468,19546,6917,5667,30.35%,10.74%,9%,3364,63440,5.22%,94.78%,57617,3210,246,229,5,121,
0500000US26069,"Iosco County, Michigan",25213,12625,50.07%,49.93%,51.5,1496,5.93%,490,515,105,7223,2085,1879,1148,17384,3027,7713,2600,1984,30.59%,10.31%,8%,610,24627,2.42%,97.58%,23244,164,124,153,3,56,
0500000US26071,"Iron County, Michigan",11099,5584,50.31%,49.69%,49.1,571,5.14%,217,177,86,3692,870,1033,601,7948,1634,3909,1047,1119,35.22%,9.43%,10%,206,11425,1.86%,98.14%,10823,24,93,41,0,34,
0500000US26073,"Isabella County, Michigan",70363,36250,51.52%,48.48%,35.7,8552,12.15%,4152,12181,1925,12624,3338,6306,5245,36147,11551,16776,15519,8231,23.84%,22.06%,12%,3006,61388,4.27%,95.73%,52970,2076,2025,1116,17,182,
0500000US26075,"Jackson County, Michigan",158174,77420,48.95%,51.05%,47.2,7362,4.65%,5392,5656,557,36544,11813,16613,8257,101282,24870,41936,17469,17170,26.51%,11.04%,11%,6184,154182,3.91%,96.09%,131097,12385,515,1475,30,473,
0500000US26077,"Kalamazoo County, Michigan",264322,135024,51.08%,48.92%,45.9,17895,6.77%,10725,22102,5098,37924,15248,40035,26112,156494,66147,48649,37350,45133,18.41%,14.13%,17%,14776,246894,5.59%,94.41%,193428,29686,819,6983,57,1367,
0500000US26079,"Kalkaska County, Michigan",17725,8672,48.93%,51.08%,53.9,1145,6.46%,412,364,65,5158,1043,1131,713,11300,1844,5570,1407,1196,31.42%,7.94%,7%,355,17584,2.00%,98.00%,16523,40,139,60,0,59,
0500000US26081,"Kent County, Michigan",652617,330789,50.69%,49.31%,50.3,32676,5.01%,18072,25699,9292,104971,40103,103846,55822,396138,159668,123043,65802,113138,18.85%,10.08%,17%,75228,582746,11.53%,88.47%,465491,62359,1818,21799,175,2331,
0500000US26083,"Keweenaw County, Michigan",2102,1024,48.72%,51.28%,64.9,129,6.14%,11,42,27,528,175,347,272,1660,619,539,217,374,25.64%,10.32%,18%,27,2019,1.28%,98.72%,1948,4,1,0,0,5,
0500000US26085,"Lake County, Michigan",11805,5790,49.05%,50.95%,50.7,815,6.90%,277,202,26,3474,688,878,361,7599,1239,3751,890,904,31.77%,7.54%,8%,1195,10901,10.12%,89.88%,9360,795,65,45,8,24,
0500000US26087,"Lapeer County, Michigan",87975,43161,49.06%,50.94%,56.2,4143,4.71%,2789,2523,302,22724,6627,7755,3734,57261,11489,25513,9150,8057,29.00%,10.40%,9%,4244,84375,4.82%,95.18%,78871,966,277,396,8,250,
0500000US26089,"Leelanau County, Michigan",21649,11011,50.86%,49.14%,59.5,604,2.79%,466,571,106,3473,1539,4507,3351,16139,7858,3939,2110,4613,18.19%,9.75%,21%,917,21384,4.24%,95.76%,19781,64,577,106,4,58,
0500000US26091,"Lenawee County, Michigan",98310,48626,49.46%,50.54%,51.6,4351,4.43%,3149,4342,379,25467,6338,9123,5300,62345,14423,28616,10680,9502,29.11%,10.86%,10%,8494,90929,8.64%,91.36%,83126,2437,342,476,8,299,
0500000US26093,"Livingston County, Michigan",190832,95077,49.82%,50.18%,57.7,5267,2.76%,5194,6325,2005,35200,13601,33271,15927,128754,49198,40394,19926,35276,21.17%,10.44%,18%,5503,188363,2.88%,97.12%,176756,1117,512,1626,113,567,
0500000US26095,"Luce County, Michigan",6286,2584,41.11%,58.89%,48.3,208,3.31%,112,124,48,1710,452,558,388,4341,946,1822,576,606,28.99%,9.16%,10%,74,5265,1.18%,98.82%,4514,12,365,2,0,10,
0500000US26097,"Mackinac County, Michigan",10781,5260,48.79%,51.21%,56.2,597,5.54%,248,212,55,2888,668,1185,834,7637,2019,3136,880,1240,29.09%,8.16%,12%,167,10667,1.55%,98.45%,8015,56,1682,28,0,34,
0500000US26099,"Macomb County, Michigan",870893,446850,51.31%,48.69%,49.1,33346,3.83%,23532,30649,8590,181952,66365,103772,56063,557903,159835,205484,97014,112362,23.59%,11.14%,13%,26214,855003,3.01%,96.99%,665241,108532,1766,38244,193,2939,
0500000US26101,"Manistee County, Michigan",24539,11948,48.69%,51.31%,50.8,1152,4.69%,672,491,115,6228,1859,2894,1240,16792,4134,6900,2350,3009,28.12%,9.58%,12%,830,24202,3.38%,96.62%,21836,606,487,79,2,57,
0500000US26103,"Marquette County, Michigan",66403,32934,49.60%,50.40%,46.8,4649,7.00%,2335,5804,960,13079,4248,10663,4451,42535,15114,15414,10052,11623,23.21%,15.14%,18%,1344,64673,2.02%,97.98%,59038,790,1011,400,17,178,
0500000US26105,"Mason County, Michigan",29062,14598,50.23%,49.77%,53.6,1515,5.21%,688,830,100,7505,2636,2842,1833,19402,4675,8193,3466,2942,28.19%,11.93%,10%,1290,27762,4.44%,95.56%,25944,167,219,154,8,81,
0500000US26107,"Mecosta County, Michigan",43481,21306,49.00%,51.00%,42.7,3727,8.57%,1769,4682,791,10039,2644,3830,2472,25150,6302,11808,7326,4621,27.16%,16.85%,11%,1026,38688,2.36%,97.64%,35521,772,190,312,14,118,
0500000US26109,"Menominee County, Michigan",22902,11231,49.04%,50.96%,53.4,1008,4.40%,709,596,61,7249,2001,2061,950,16003,3011,7958,2597,2122,34.75%,11.34%,9%,486,23016,2.12%,97.88%,21325,98,727,94,5,33,
0500000US26111,"Midland County, Michigan",83445,42324,50.72%,49.28%,56.6,3276,3.93%,2299,3013,968,17080,6358,11944,8466,55434,20410,19379,9371,12912,23.22%,11.23%,15%,2659,80835,3.19%,96.81%,73825,942,293,1710,83,320,
0500000US26113,"Missaukee County, Michigan",15075,7436,49.33%,50.67%,56.9,776,5.15%,556,313,51,4328,1269,1162,500,9547,1662,4884,1582,1213,32.40%,10.49%,8%,499,14553,3.31%,96.69%,13940,33,48,43,1,23,
0500000US26115,"Monroe County, Michigan",150000,75991,50.66%,49.34%,52.1,7024,4.68%,3830,5580,660,36223,12778,14465,7876,97039,22341,40053,18358,15125,26.70%,12.24%,10%,6231,148578,4.15%,95.85%,135369,4036,414,952,24,490,
0500000US26117,"Montcalm County, Michigan",63516,30838,48.55%,51.45%,52.7,3304,5.20%,2004,1851,249,17676,4241,4537,1915,39714,6452,19680,6092,4786,30.98%,9.59%,8%,2697,63917,4.25%,95.75%,58880,2118,212,225,23,136,
0500000US26119,"Montmorency County, Michigan",9270,4595,49.57%,50.43%,55.4,572,6.17%,192,138,80,3065,799,701,392,6556,1093,3257,937,781,35.13%,10.11%,8%,125,9028,1.35%,98.65%,8551,12,68,24,0,34,
0500000US26121,"Muskegon County, Michigan",173679,87465,50.36%,49.64%,46.6,10304,5.93%,5023,6134,763,40041,14587,16386,7146,108914,23532,45064,20721,17149,25.95%,11.93%,10%,10283,165541,5.92%,94.08%,130141,23622,1106,1073,31,537,
0500000US26123,"Newaygo County, Michigan",48687,24221,49.75%,50.25%,56.1,2647,5.44%,1399,1435,145,14098,3311,4035,1824,30478,5859,15497,4746,4180,31.83%,9.75%,9%,2969,47009,6.10%,93.90%,43915,424,256,189,14,126,
0500000US26125,"Oakland County, Michigan",1255340,640307,51.01%,48.99%,50.8,41662,3.32%,29602,42805,19232,163572,73102,242679,184407,840156,427086,193174,115907,261911,15.39%,9.23%,21%,60838,1213557,4.85%,95.15%,879137,168797,2236,105665,304,5230,
0500000US26127,"Oceana County, Michigan",26545,13076,49.26%,50.74%,56.2,1666,6.28%,883,695,76,6793,1776,2387,1228,16187,3615,7676,2471,2463,28.92%,9.31%,9%,4108,22551,15.48%,84.52%,21191,123,195,69,4,79,
0500000US26129,"Ogemaw County, Michigan",20895,10408,49.81%,50.19%,53.7,1211,5.80%,522,507,32,5800,1825,1295,641,13635,1936,6322,2332,1327,30.26%,11.16%,6%,437,20333,2.09%,97.91%,19268,59,108,57,8,58,
0500000US26131,"Ontonagon County, Michigan",5802,2858,49.26%,50.74%,54.5,343,5.91%,108,133,10,2121,515,500,233,4452,733,2229,648,510,38.42%,11.17%,9%,68,5748,1.17%,98.83%,5434,8,60,20,2,10,
0500000US26133,"Osceola County, Michigan",23323,11496,49.29%,50.71%,54,1442,6.18%,705,476,76,6907,1503,1666,801,14614,2467,7612,1979,1742,32.64%,8.49%,7%,400,22491,1.72%,98.28%,21188,155,142,34,6,61,
0500000US26135,"Oscoda County, Michigan",8282,4085,49.32%,50.68%,57.7,425,5.13%,115,185,20,2235,430,470,272,5069,742,2350,615,490,28.37%,7.43%,6%,154,8065,1.86%,98.14%,7684,8,34,5,0,11,
0500000US26137,"Otsego County, Michigan",24613,12337,50.12%,49.88%,53.5,1231,5.00%,564,838,99,5631,1919,2973,1529,16415,4502,6195,2757,3072,25.17%,11.20%,12%,446,24645,1.81%,98.19%,23156,100,151,91,0,60,
0500000US26139,"Ottawa County, Michigan",289162,146214,50.57%,49.44%,56.4,9880,3.42%,11323,20323,3761,49246,17801,42239,21366,169343,63605,60569,38124,46000,20.95%,13.18%,16%,29382,266818,10.16%,89.84%,241520,5071,726,7895,95,851,
0500000US26141,"Presque Isle County, Michigan",12687,6372,50.23%,49.78%,60.7,641,5.05%,239,296,47,3634,1110,1203,670,8983,1873,3873,1406,1250,30.53%,11.08%,10%,154,12828,1.21%,98.79%,12282,28,67,52,0,26,
0500000US26143,"Roscommon County, Michigan",23863,11903,49.88%,50.12%,52.1,1633,6.84%,392,438,99,6972,2082,1660,1442,17166,3102,7364,2520,1759,30.86%,10.56%,7%,434,23025,1.82%,98.18%,21883,60,94,76,10,47,
0500000US26145,"Saginaw County, Michigan",191166,98371,51.46%,48.54%,45.5,13472,7.05%,5857,8796,993,43206,14307,19176,9959,119148,29135,49063,23103,20169,25.67%,12.09%,11%,16904,173220,8.84%,91.16%,128722,33548,462,2373,85,769,
0500000US26147,"St. Clair County, Michigan",159285,80121,50.30%,49.70%,52.2,8854,5.56%,4826,4973,688,38047,14019,13453,8197,103606,21650,42873,18992,14141,26.92%,11.92%,9%,5505,154878,3.46%,96.54%,142396,3773,561,809,13,443,
0500000US26149,"St. Joseph County, Michigan",60789,30491,50.16%,49.84%,52.8,3161,5.20%,1697,1709,173,14799,4419,4139,2424,35412,6563,16496,6128,4312,27.14%,10.08%,7%,5427,55512,8.93%,91.07%,50674,1341,151,414,9,174,
0500000US26151,"Sanilac County, Michigan",41179,20660,50.17%,49.83%,56,2470,6.00%,1370,848,133,12258,2912,2740,1608,26282,4348,13628,3760,2873,33.09%,9.13%,7%,1674,38937,4.07%,95.93%,37209,151,112,84,2,98,
0500000US26153,"Schoolcraft County, Michigan",8031,4067,50.64%,49.36%,56.7,453,5.64%,234,99,23,2582,650,808,367,5566,1175,2816,749,831,35.06%,9.33%,10%,96,7951,1.20%,98.80%,6727,10,699,15,1,5,
0500000US26155,"Shiawassee County, Michigan",68176,34425,50.49%,49.51%,52.2,3061,4.49%,2481,2336,226,17333,5464,5776,2782,44549,8558,19814,7800,6002,29.06%,11.44%,9%,2024,66070,2.97%,97.03%,62239,319,223,288,19,188,
0500000US26157,"Tuscola County, Michigan",52683,26176,49.69%,50.31%,54.1,2815,5.34%,1701,1299,217,16372,4034,3488,1628,34234,5116,18073,5333,3705,34.31%,10.12%,7%,1808,51515,3.43%,96.57%,48611,402,174,155,12,132,
0500000US26159,"Van Buren County, Michigan",75416,37916,50.28%,49.72%,54.9,4482,5.94%,2333,2348,233,16620,5150,6957,3871,45414,10828,18953,7498,7190,25.13%,9.94%,10%,8966,66621,11.89%,88.11%,59400,2348,552,384,27,285,
0500000US26161,"Washtenaw County, Michigan",368385,185842,50.45%,49.55%,44.2,28452,7.72%,12409,37749,14532,33997,15759,61734,69539,221460,131273,46406,53508,76266,12.60%,14.53%,21%,20731,351527,5.63%,94.37%,252220,42125,715,33517,183,2051,
0500000US26163,"Wayne County, Michigan",1753059,908957,51.85%,48.15%,38.9,173689,9.91%,53164,60748,15143,346244,101942,181260,117752,1032733,299012,399408,162690,196403,22.78%,9.28%,11%,117649,1675912,6.71%,93.29%,857132,669277,4265,64604,322,7974,
0500000US26165,"Wexford County, Michigan",33433,16752,50.11%,49.89%,52.4,2011,6.02%,1040,679,110,8170,2299,3147,1436,20891,4583,9210,2978,3257,27.55%,8.91%,10%,790,32883,2.36%,97.64%,30783,187,163,186,1,112,
0500000US27001,"Aitkin County, Minnesota",15826,7831,49.48%,50.52%,59.5,779,4.92%,388,316,46,4401,1551,1571,709,11394,2280,4789,1867,1617,30.26%,11.80%,10%,220,15477,1.39%,98.61%,14479,58,376,38,1,25,
0500000US27003,"Anoka County, Minnesota",353775,176812,49.98%,50.02%,53.2,8995,2.54%,9011,11975,2845,67543,31130,52115,21276,227654,73391,76554,43105,54960,21.64%,12.18%,16%,19506,344381,5.51%,94.49%,276205,28378,1912,19158,93,1401,
0500000US27005,"Becker County, Minnesota",34227,17198,50.25%,49.75%,55.3,1559,4.55%,1033,807,216,6907,3218,4214,1821,21834,6035,7940,4025,4430,23.20%,11.76%,13%,575,34608,1.68%,98.32%,29645,200,2417,156,9,100,
0500000US27007,"Beltrami County, Minnesota",46784,23501,50.23%,49.77%,41.6,3351,7.16%,1462,3329,465,8016,3492,5330,3298,26603,8628,9478,6821,5795,20.26%,14.58%,12%,1108,45120,2.37%,97.63%,32445,519,9198,268,15,134,
0500000US27009,"Benton County, Minnesota",40476,20339,50.25%,49.75%,50.4,1439,3.56%,993,1484,348,7900,3904,4556,1665,24546,6221,8893,5388,4904,21.97%,13.31%,12%,1216,40163,3.00%,97.00%,35821,1991,184,463,8,109,
0500000US27011,"Big Stone County, Minnesota",4974,2501,50.28%,49.72%,60.6,206,4.14%,64,134,84,1499,467,425,229,3321,654,1563,601,509,31.42%,12.08%,10%,140,5026,2.81%,97.19%,4809,19,34,12,4,34,
0500000US27013,"Blue Earth County, Minnesota",67368,33673,49.98%,50.02%,43.2,4693,6.97%,3036,9758,1280,10774,5013,9086,4565,37381,13651,13810,14771,10366,20.50%,21.93%,15%,3221,65891,4.78%,95.22%,57222,3873,208,1834,24,247,
0500000US27015,"Brown County, Minnesota",25076,12518,49.92%,50.08%,56.7,579,2.31%,663,1214,288,6166,1888,2842,1053,16000,3895,6829,3102,3130,27.23%,12.37%,12%,1171,24741,4.67%,95.33%,23968,118,39,126,6,20,
0500000US27017,"Carlton County, Minnesota",35709,17009,47.63%,52.37%,52.1,1831,5.13%,1126,1018,153,7997,3254,3898,1768,23651,5666,9123,4272,4051,25.55%,11.96%,11%,612,35595,1.71%,98.29%,30910,556,2148,153,12,85,
0500000US27019,"Carver County, Minnesota",103561,52065,50.28%,49.73%,61.1,1958,1.89%,2218,3536,1227,11776,7861,22831,10458,65332,33289,13994,11397,24058,13.51%,11.01%,23%,5308,101614,5.13%,94.87%,91443,2173,193,3617,15,284,
0500000US27021,"Cass County, Minnesota",29462,14358,48.73%,51.27%,56,1748,5.93%,643,646,45,6966,2338,3888,1509,20124,5397,7609,2984,3933,25.83%,10.13%,13%,426,29640,1.45%,98.55%,24675,64,3424,111,0,96,
0500000US27023,"Chippewa County, Minnesota",11876,5936,49.98%,50.02%,56.5,482,4.06%,258,369,184,2690,1233,1237,385,7343,1622,2948,1602,1421,24.82%,13.49%,12%,1243,11355,10.47%,89.53%,10473,75,102,44,296,49,
0500000US27025,"Chisago County, Minnesota",55844,26808,48.01%,52.00%,58.7,1720,3.08%,1873,1396,322,12880,5881,6362,2294,37119,8656,14753,7277,6684,26.42%,13.03%,12%,1451,55170,2.60%,97.40%,50804,845,309,768,3,185,
0500000US27027,"Clay County, Minnesota",64029,32547,50.83%,49.17%,49.4,2770,4.33%,2164,5853,697,8961,5940,9390,3894,37034,13284,11125,11793,10087,17.37%,18.42%,16%,3011,62307,4.70%,95.30%,54424,3141,1032,764,16,134,
0500000US27029,"Clearwater County, Minnesota",8872,4387,49.45%,50.55%,51.9,397,4.47%,243,194,37,2193,674,771,298,5198,1069,2436,868,808,27.46%,9.78%,9%,101,8423,1.14%,98.86%,7151,19,752,23,2,22,
0500000US27031,"Cook County, Minnesota",5402,2703,50.04%,49.96%,62.4,220,4.07%,95,97,39,955,432,1292,642,4152,1934,1050,529,1331,19.44%,9.79%,25%,123,5477,2.28%,97.72%,4670,25,450,48,1,25,
0500000US27033,"Cottonwood County, Minnesota",11279,5644,50.04%,49.96%,56.1,489,4.34%,466,238,23,2627,968,1153,443,6928,1596,3093,1206,1176,27.42%,10.69%,10%,1115,10402,9.89%,90.11%,9418,135,25,361,80,53,
0500000US27035,"Crow Wing County, Minnesota",64775,32557,50.26%,49.74%,55.9,2311,3.57%,1567,1863,303,13736,6305,7792,4358,43799,12150,15303,8168,8095,23.62%,12.61%,12%,912,65211,1.41%,98.59%,61252,383,623,332,19,240,
0500000US27037,"Dakota County, Minnesota",425271,215434,50.66%,49.34%,55.3,11904,2.80%,9957,12894,6130,57136,34809,84286,38302,273445,122588,67093,47703,90416,15.78%,11.22%,21%,36305,403577,8.54%,91.46%,323629,32191,1490,23932,184,2144,
0500000US27039,"Dodge County, Minnesota",20807,10307,49.54%,50.46%,59.4,416,2.00%,645,601,128,4308,2158,2851,928,12973,3779,4953,2759,2979,23.80%,13.26%,14%,1057,19810,5.08%,94.92%,18807,126,37,104,1,65,
0500000US27041,"Douglas County, Minnesota",37820,18822,49.77%,50.23%,60.8,1061,2.81%,643,1545,164,8287,4993,5186,2180,25903,7366,8930,6538,5350,23.61%,17.29%,14%,815,38191,2.15%,97.85%,36629,223,104,227,11,60,
0500000US27043,"Faribault County, Minnesota",13727,6819,49.68%,50.32%,55.1,590,4.30%,302,304,86,3464,1309,1490,449,9033,1939,3766,1613,1576,27.43%,11.75%,11%,1013,12908,7.38%,92.62%,12402,55,58,45,0,39,
0500000US27045,"Fillmore County, Minnesota",21031,10436,49.62%,50.38%,62.2,800,3.80%,478,478,144,4608,1941,2257,999,13180,3256,5086,2419,2401,24.18%,11.50%,11%,341,20887,1.62%,98.38%,20173,98,7,71,2,65,
0500000US27047,"Freeborn County, Minnesota",30465,15304,50.24%,49.77%,52.8,1323,4.34%,690,673,139,7455,3132,2588,1125,19227,3713,8145,3805,2727,26.74%,12.49%,9%,3183,27712,10.45%,89.55%,25071,460,76,1135,5,79,
0500000US27049,"Goodhue County, Minnesota",46330,23207,50.09%,49.91%,56.7,1474,3.18%,1224,1060,461,10588,4261,5675,2946,30581,8621,11812,5321,6136,25.50%,11.48%,13%,1797,45785,3.88%,96.12%,42516,661,540,348,33,155,
0500000US27051,"Grant County, Minnesota",5962,2930,49.15%,50.86%,59.3,170,2.85%,135,142,34,1449,723,557,201,3946,758,1584,865,591,26.57%,14.51%,10%,135,5939,2.26%,97.74%,5699,13,27,14,7,4,
0500000US27053,"Hennepin County, Minnesota",1255296,634437,50.54%,49.46%,47.4,60065,4.78%,26181,43907,24730,138589,76388,282899,162699,817703,445598,164770,120295,307629,13.13%,9.58%,25%,98250,1183315,7.83%,92.17%,840845,169603,8016,97348,388,6127,
0500000US27055,"Houston County, Minnesota",18670,9361,50.14%,49.86%,59.5,716,3.84%,512,414,163,4741,2085,2288,938,12657,3226,5253,2499,2451,28.14%,13.39%,13%,243,18600,1.30%,98.70%,17840,90,42,101,4,31,
0500000US27057,"Hubbard County, Minnesota",21287,10443,49.06%,50.94%,58.8,893,4.20%,466,347,109,4588,1999,2895,1524,14598,4419,5054,2346,3004,23.74%,11.02%,14%,489,20855,2.30%,97.70%,19139,82,560,66,12,56,
0500000US27059,"Isanti County, Minnesota",40004,19769,49.42%,50.58%,54.6,984,2.46%,1093,1115,325,9833,3095,3537,1461,25473,4998,10926,4210,3862,27.31%,10.52%,10%,896,40239,2.24%,97.76%,37559,314,201,488,13,154,
0500000US27061,"Itasca County, Minnesota",45180,22317,49.40%,50.60%,57,2487,5.50%,994,1437,174,10095,4228,5279,2792,30871,8071,11089,5665,5453,24.54%,12.54%,12%,618,44396,1.37%,98.63%,40166,174,1497,145,2,125,
0500000US27063,"Jackson County, Minnesota",9873,4850,49.12%,50.88%,60.2,254,2.57%,211,222,107,2455,972,1283,328,6606,1611,2666,1194,1390,27.00%,12.09%,14%,401,9588,4.06%,95.94%,9026,120,22,122,0,23,
0500000US27065,"Kanabec County, Minnesota",16205,8062,49.75%,50.25%,55.4,624,3.85%,490,315,52,4474,1236,1086,609,10398,1695,4964,1551,1138,30.63%,9.57%,7%,238,15794,1.47%,98.53%,14954,65,113,80,0,15,
0500000US27067,"Kandiyohi County, Minnesota",42909,21450,49.99%,50.01%,56.7,2170,5.06%,1342,1218,419,7834,4669,4919,2122,26249,7041,9176,5887,5338,21.38%,13.72%,12%,5916,37816,13.79%,86.21%,33303,2618,115,586,37,98,
0500000US27069,"Kittson County, Minnesota",4272,2122,49.67%,50.33%,57.2,223,5.22%,144,89,12,1219,262,552,256,2974,808,1363,351,564,31.91%,8.22%,13%,83,4124,1.94%,98.06%,3974,1,15,17,6,14,
0500000US27071,"Koochiching County, Minnesota",12355,6142,49.71%,50.29%,51.8,541,4.38%,218,480,72,3336,1183,982,420,8635,1402,3554,1663,1054,28.77%,13.46%,9%,167,11895,1.35%,98.65%,10920,44,278,34,12,30,
0500000US27073,"Lac qui Parle County, Minnesota",6645,3311,49.83%,50.17%,61.2,196,2.95%,88,174,100,1858,663,689,235,4591,924,1946,837,789,29.29%,12.60%,12%,202,6517,3.04%,96.96%,6244,32,10,40,0,16,
0500000US27075,"Lake County, Minnesota",10571,5090,48.15%,51.85%,61.2,344,3.25%,303,243,14,2435,1120,1504,749,7612,2253,2738,1363,1518,25.90%,12.89%,14%,113,10792,1.07%,98.93%,10281,11,50,55,0,30,
0500000US27077,"Lake of the Woods County, Minnesota",3747,1743,46.52%,53.48%,52.3,183,4.88%,60,102,15,1000,344,514,84,2696,598,1060,446,529,28.29%,11.90%,14%,56,3707,1.49%,98.51%,3497,12,19,17,0,13,
0500000US27079,"Le Sueur County, Minnesota",28425,14107,49.63%,50.37%,57.7,1125,3.96%,703,709,278,6932,2838,3227,1266,18572,4493,7635,3547,3505,26.86%,12.48%,12%,1872,26802,6.59%,93.41%,25463,262,67,134,20,58,
0500000US27081,"Lincoln County, Minnesota",5641,2800,49.64%,50.36%,58.1,212,3.76%,137,105,60,1477,519,553,211,3656,764,1614,624,613,28.61%,11.06%,11%,107,5533,1.90%,98.10%,5368,10,11,22,0,3,
0500000US27083,"Lyon County, Minnesota",25696,13035,50.73%,49.27%,51.6,1146,4.46%,637,1557,252,5079,2195,3176,1137,15216,4313,5716,3752,3428,22.24%,14.60%,13%,1744,23525,6.79%,93.21%,20535,906,84,1263,3,41,
0500000US27085,"McLeod County, Minnesota",35788,17980,50.24%,49.76%,54,1010,2.82%,971,1215,218,8406,4329,2970,1326,23172,4296,9377,5544,3188,26.20%,15.49%,9%,2555,34216,7.14%,92.86%,32559,226,102,230,27,64,
0500000US27087,"Mahnomen County, Minnesota",5508,2716,49.31%,50.69%,40.8,591,10.73%,129,108,20,1197,442,306,126,2888,432,1326,550,326,24.07%,9.99%,6%,154,5257,2.80%,97.20%,2278,8,2256,7,0,17,
0500000US27089,"Marshall County, Minnesota",9353,4612,49.31%,50.69%,60,205,2.19%,257,233,73,2492,866,906,304,5894,1210,2749,1099,979,29.39%,11.75%,10%,390,8650,4.17%,95.83%,8332,12,29,19,0,22,
0500000US27091,"Martin County, Minnesota",19737,9832,49.82%,50.19%,56.6,1158,5.87%,447,522,47,5000,1823,2202,848,13156,3050,5447,2345,2249,27.60%,11.88%,11%,1320,18705,6.69%,93.31%,17947,112,32,92,6,46,
0500000US27093,"Meeker County, Minnesota",23149,11316,48.88%,51.12%,58.1,483,2.09%,805,574,86,5670,2313,1987,884,14772,2871,6475,2887,2073,27.97%,12.47%,9%,950,22450,4.10%,95.90%,21618,93,37,59,2,49,
0500000US27095,"Mille Lacs County, Minnesota",25963,12936,49.83%,50.18%,49.5,1273,4.90%,698,628,124,6681,2298,1936,930,16176,2866,7379,2926,2060,28.42%,11.27%,8%,481,25978,1.85%,98.15%,23131,78,1466,124,6,98,
0500000US27097,"Morrison County, Minnesota",33119,16383,49.47%,50.53%,56.8,1146,3.46%,885,834,197,8891,2860,2933,1041,20948,3974,9776,3694,3130,29.52%,11.15%,9%,633,33377,1.91%,98.09%,32032,179,111,102,5,57,
0500000US27099,"Mower County, Minnesota",39931,19704,49.35%,50.66%,53.1,1684,4.22%,879,898,298,8740,3220,4120,1929,23640,6049,9619,4118,4418,24.09%,10.31%,11%,5081,34948,12.72%,87.28%,29804,1613,57,2052,255,123,
0500000US27101,"Murray County, Minnesota",8247,4130,50.08%,49.92%,58.8,159,1.93%,167,208,66,2116,626,910,320,5335,1230,2283,834,976,27.68%,10.11%,12%,382,7797,4.63%,95.37%,7483,26,9,105,3,7,
0500000US27103,"Nicollet County, Minnesota",34176,17137,50.14%,49.86%,50.7,1270,3.72%,1123,2611,391,5466,2868,5092,2554,20855,7646,6589,5479,5483,19.28%,16.03%,16%,1800,32654,5.27%,94.73%,29287,1672,141,558,10,71,
0500000US27105,"Nobles County, Minnesota",21667,10400,48.00%,52.00%,52.8,1115,5.15%,542,717,217,4314,1539,1630,625,10747,2255,4856,2256,1847,22.41%,10.41%,9%,7271,15019,33.56%,66.44%,12147,978,66,1329,41,42,
0500000US27107,"Norman County, Minnesota",6466,3239,50.09%,49.91%,52.4,319,4.93%,124,179,96,1591,620,760,198,4166,958,1715,799,856,26.52%,12.36%,13%,288,6153,4.45%,95.55%,5702,17,115,18,0,32,
0500000US27109,"Olmsted County, Minnesota",156446,80046,51.17%,48.84%,55.4,5743,3.67%,3832,4242,2797,20368,12490,28239,21174,100015,49413,24200,16732,31036,15.47%,10.70%,20%,9196,153651,5.88%,94.12%,124758,10959,380,10190,66,548,
0500000US27111,"Otter Tail County, Minnesota",58416,29045,49.72%,50.28%,60.3,2162,3.70%,1353,1658,339,11355,6495,7497,3296,38389,10793,12708,8153,7836,21.75%,13.96%,13%,2216,57865,3.79%,96.21%,54362,843,284,334,17,149,
0500000US27113,"Pennington County, Minnesota",14110,7116,50.43%,49.57%,51.4,513,3.64%,579,393,114,3050,1906,1416,495,9119,1911,3629,2299,1530,25.72%,16.29%,11%,671,13321,4.76%,95.24%,12241,177,166,121,6,48,
0500000US27115,"Pine County, Minnesota",29254,13596,46.48%,53.52%,47.6,1326,4.53%,895,593,106,8844,2283,2268,1019,19606,3287,9739,2876,2374,33.29%,9.83%,8%,713,28163,2.44%,97.56%,25119,470,966,264,1,98,
0500000US27117,"Pipestone County, Minnesota",9163,4730,51.62%,48.38%,57.8,447,4.88%,165,193,80,2280,675,939,262,5608,1201,2445,868,1019,26.68%,9.47%,11%,804,8620,8.77%,91.23%,8057,107,100,66,0,19,
0500000US27119,"Polk County, Minnesota",31384,15414,49.11%,50.89%,52.5,1673,5.33%,796,1196,229,6445,2766,4029,1727,19670,5756,7241,3962,4258,23.07%,12.62%,14%,1999,29193,6.37%,93.63%,26538,958,376,156,4,71,
0500000US27121,"Pope County, Minnesota",11107,5514,49.64%,50.36%,61.8,218,1.96%,167,336,67,2516,1435,1161,661,7647,1822,2683,1771,1228,24.16%,15.94%,11%,191,11117,1.72%,98.28%,10751,34,27,50,0,20,
0500000US27123,"Ramsey County, Minnesota",546598,279935,51.21%,48.79%,43.7,31256,5.72%,14678,24084,8944,77055,31697,95272,62080,332939,157352,91733,55781,104216,16.78%,10.21%,19%,45034,507318,8.24%,91.76%,320477,70101,2914,85775,214,2339,
0500000US27125,"Red Lake County, Minnesota",4005,1955,48.81%,51.19%,58.2,140,3.50%,94,77,7,1020,482,394,84,2639,478,1114,559,401,27.82%,13.96%,10%,103,3832,2.57%,97.43%,3625,15,57,5,3,14,
0500000US27127,"Redwood County, Minnesota",15193,7527,49.54%,50.46%,55.9,540,3.55%,437,386,130,3857,1079,1495,477,9516,1972,4294,1465,1625,28.26%,9.64%,11%,496,14929,3.26%,96.74%,13123,76,774,414,1,16,
0500000US27129,"Renville County, Minnesota",14572,7159,49.13%,50.87%,54.7,612,4.20%,404,345,72,3709,1398,1188,346,9217,1534,4113,1743,1260,28.23%,11.96%,9%,1319,13404,9.05%,90.95%,12766,60,103,61,5,27,
0500000US27131,"Rice County, Minnesota",66549,32697,49.13%,50.87%,48.8,2864,4.30%,1789,6733,526,13410,4883,7520,4559,38776,12079,15199,11616,8046,22.84%,17.45%,12%,6783,60314,10.19%,89.81%,51523,4353,297,1554,10,425,
0500000US27133,"Rock County, Minnesota",9386,4852,51.69%,48.31%,62.8,333,3.55%,221,238,62,2020,939,1095,443,6014,1538,2241,1177,1157,23.88%,12.54%,12%,364,9340,3.88%,96.12%,8886,50,48,62,10,0,
0500000US27135,"Roseau County, Minnesota",15259,7345,48.14%,51.86%,54.7,580,3.80%,443,407,114,3650,1288,1549,425,9498,1974,4093,1695,1663,26.82%,11.11%,11%,238,15093,1.56%,98.44%,13700,85,229,398,10,56,
0500000US27137,"St. Louis County, Minnesota",199499,99505,49.88%,50.12%,46.9,12788,6.41%,6064,13857,3199,35384,18601,26729,14413,128913,41142,41448,32458,29928,20.78%,16.27%,15%,3603,196628,1.81%,98.19%,176112,4075,4305,1901,58,579,
0500000US27139,"Scott County, Minnesota",147201,73980,50.26%,49.74%,57.9,3495,2.37%,3839,4030,1825,20119,12530,27613,11347,90590,38960,23958,16560,29438,16.28%,11.25%,20%,9008,141920,6.12%,93.88%,115630,8137,1406,9939,64,607,
0500000US27141,"Sherburne County, Minnesota",96015,47070,49.02%,50.98%,53.6,2208,2.30%,3266,2844,675,17937,9110,11410,4731,59192,16141,21203,11954,12085,22.08%,12.45%,13%,2820,94363,2.94%,97.06%,84761,3648,390,1277,22,313,
0500000US27143,"Sibley County, Minnesota",14871,7312,49.17%,50.83%,57.7,484,3.25%,504,306,114,4036,1326,1303,407,9544,1710,4540,1632,1417,30.53%,10.97%,10%,1315,13521,8.84%,91.16%,12942,81,30,72,10,25,
0500000US27145,"Stearns County, Minnesota",159788,79351,49.66%,50.34%,49.2,7586,4.75%,4642,15061,2198,27978,13412,18783,8796,91136,27579,32620,28473,20981,20.41%,17.82%,13%,6951,151341,4.35%,95.65%,129276,13224,439,3159,61,435,
0500000US27147,"Steele County, Minnesota",36710,18370,50.04%,49.96%,58.4,974,2.65%,1140,1036,264,7860,3022,4597,2024,22892,6621,9000,4058,4861,24.52%,11.05%,13%,3140,34266,8.55%,91.45%,31376,1359,65,330,18,58,
0500000US27149,"Stevens County, Minnesota",9770,4872,49.87%,50.13%,53.6,796,8.15%,321,1144,215,1890,818,1206,549,5579,1755,2211,1962,1421,22.63%,20.08%,15%,986,8685,10.09%,89.91%,8093,84,110,68,1,40,
0500000US27151,"Swift County, Minnesota",9329,4684,50.21%,49.79%,54.4,394,4.22%,162,269,72,2113,1064,1141,267,5961,1408,2275,1333,1213,24.39%,14.29%,13%,662,9176,7.10%,92.90%,8618,79,26,78,133,5,
0500000US27153,"Todd County, Minnesota",24603,11949,48.57%,51.43%,59.2,1639,6.66%,539,610,114,6495,2171,1787,588,14890,2375,7034,2781,1901,28.59%,11.30%,8%,2208,23054,8.97%,91.03%,22117,95,76,97,72,65,
0500000US27155,"Traverse County, Minnesota",3282,1662,50.64%,49.36%,54.9,98,2.99%,71,103,10,929,438,278,103,2276,381,1000,541,288,30.47%,16.48%,9%,197,3163,6.00%,94.00%,2851,21,183,0,0,5,
0500000US27157,"Wabasha County, Minnesota",21564,10702,49.63%,50.37%,58.6,630,2.92%,397,653,201,5101,2150,2558,1227,14558,3785,5498,2803,2759,25.50%,13.00%,13%,708,20679,3.28%,96.72%,19921,121,32,97,6,20,
0500000US27159,"Wadena County, Minnesota",13681,6914,50.54%,49.46%,51.4,429,3.14%,416,330,85,3261,1318,1228,336,8471,1564,3677,1648,1313,26.88%,12.05%,10%,273,13792,2.00%,98.00%,13044,118,73,54,9,19,
0500000US27161,"Waseca County, Minnesota",18658,9742,52.21%,47.79%,54.6,678,3.63%,506,499,142,4658,1797,2103,747,12048,2850,5164,2296,2245,27.68%,12.31%,12%,1271,17697,6.81%,93.19%,16538,336,114,111,12,21,
0500000US27163,"Washington County, Minnesota",259072,130839,50.50%,49.50%,56.8,5661,2.19%,6091,8246,3555,35713,18401,51366,28576,168295,79942,41804,26647,54921,16.14%,10.29%,21%,13094,254474,5.05%,94.95%,208277,13799,999,18530,72,969,
0500000US27165,"Watonwan County, Minnesota",10903,5494,50.39%,49.61%,54.7,534,4.90%,320,252,76,2782,716,964,340,6255,1304,3102,968,1040,28.45%,8.88%,10%,3227,8026,29.60%,70.40%,7689,42,13,86,0,15,
0500000US27167,"Wilkin County, Minnesota",6264,2979,47.56%,52.44%,51.8,210,3.35%,106,200,46,1406,871,828,226,4213,1054,1512,1071,874,24.14%,17.10%,14%,211,6295,3.37%,96.63%,5918,41,87,8,1,5,
0500000US27169,"Winona County, Minnesota",50744,25546,50.34%,49.66%,43.9,2753,5.43%,1894,7135,590,8482,4575,6487,3381,29529,9868,10376,11710,7077,20.45%,23.08%,14%,1889,47782,3.72%,96.28%,44178,892,84,933,0,124,
0500000US27171,"Wright County, Minnesota",136387,67321,49.36%,50.64%,59.1,3481,2.55%,3500,4102,1134,25244,11287,18987,8415,82918,27402,28744,15389,20121,21.08%,11.28%,15%,4697,136640,3.44%,96.56%,126031,2605,331,1877,35,508,
0500000US27173,"Yellow Medicine County, Minnesota",9775,4856,49.68%,50.32%,57.4,257,2.63%,259,344,35,2440,1010,851,284,6237,1135,2699,1354,886,27.61%,13.85%,9%,448,9080,4.58%,95.42%,8408,48,276,28,1,4,
0500000US28001,"Adams County, Mississippi",31103,15923,51.19%,48.81%,34,4367,14.04%,754,1104,34,6918,1671,2211,1663,16450,3874,7672,2775,2245,24.67%,8.92%,7%,1012,28526,3.25%,96.75%,10926,16709,56,165,7,35,
0500000US28003,"Alcorn County, Mississippi",37058,18789,50.70%,49.30%,45.1,2581,6.96%,1128,1281,97,8085,2257,2917,1645,20564,4562,9213,3538,3014,24.86%,9.55%,8%,1248,33492,3.37%,96.63%,27738,4316,61,180,19,50,
0500000US28005,"Amite County, Mississippi",12341,6425,52.06%,47.94%,52.7,1766,14.31%,412,165,58,4123,1096,623,463,7814,1086,4535,1261,681,36.75%,10.22%,6%,129,12591,1.05%,98.95%,7434,4835,25,31,0,18,
0500000US28007,"Attala County, Mississippi",18308,9612,52.50%,47.50%,45.6,1723,9.41%,662,526,59,3787,1227,1285,550,9536,1835,4449,1753,1344,24.30%,9.58%,7%,331,17558,1.81%,98.19%,9410,7642,29,97,4,37,
0500000US28009,"Benton County, Mississippi",8275,4207,50.84%,49.16%,51.6,708,8.56%,222,186,55,1956,296,281,317,4406,598,2178,482,336,26.32%,5.82%,4%,145,7501,1.75%,98.25%,4565,2654,6,1,0,38,
0500000US28011,"Bolivar County, Mississippi",31253,16548,52.95%,47.05%,36.7,4815,15.41%,646,2037,124,4970,2013,2925,2239,16416,5164,5616,4050,3049,17.97%,12.96%,10%,794,30191,2.54%,97.46%,9946,19257,22,262,0,52,
0500000US28013,"Calhoun County, Mississippi",14417,7505,52.06%,47.94%,48.5,911,6.32%,445,499,36,3469,1066,617,493,7672,1110,3914,1565,653,27.15%,10.86%,5%,747,12519,5.18%,94.82%,8662,3444,15,17,0,18,
0500000US28015,"Carroll County, Mississippi",9972,4816,48.30%,51.71%,52.6,471,4.72%,142,189,48,2490,1139,827,264,6336,1091,2632,1328,875,26.39%,13.32%,9%,154,9844,1.54%,98.46%,6529,3030,15,29,0,18,
0500000US28017,"Chickasaw County, Mississippi",17060,8818,51.69%,48.31%,45.9,1351,7.92%,571,701,0,4184,1209,1110,301,8752,1411,4755,1910,1110,27.87%,11.20%,7%,642,16464,3.76%,96.24%,8584,7407,13,41,0,15,
0500000US28019,"Choctaw County, Mississippi",8206,4084,49.77%,50.23%,54,366,4.46%,317,216,29,2260,427,671,500,4785,1171,2577,643,700,31.40%,7.84%,9%,117,8129,1.43%,98.57%,5559,2332,15,6,0,7,
0500000US28021,"Claiborne County, Mississippi",9042,4808,53.17%,46.83%,28.8,1638,18.12%,435,1175,66,1521,347,466,617,4160,1083,1956,1522,532,21.63%,16.83%,6%,72,9063,0.80%,99.20%,974,7959,8,0,0,8,
0500000US28023,"Clarke County, Mississippi",15612,8345,53.45%,46.55%,47.7,1844,11.81%,494,601,39,4311,1217,939,451,9216,1390,4805,1818,978,30.78%,11.64%,6%,132,15483,0.85%,99.15%,9950,5103,16,8,6,24,
0500000US28025,"Clay County, Mississippi",19515,10358,53.08%,46.92%,42.7,2385,12.22%,605,659,60,4730,1427,1774,947,11216,2721,5335,2086,1834,27.34%,10.69%,9%,186,18450,0.95%,99.05%,7196,10785,35,57,1,37,
0500000US28027,"Coahoma County, Mississippi",22685,12181,53.70%,46.30%,30,3020,13.31%,564,1117,90,3748,1872,1611,923,11548,2534,4312,2989,1701,19.01%,13.18%,7%,350,21040,1.54%,98.46%,4285,16209,26,112,0,44,
0500000US28029,"Copiah County, Mississippi",28339,15162,53.50%,46.50%,42.9,2073,7.32%,902,1651,117,6539,2281,2379,788,15854,3167,7441,3932,2496,26.26%,13.87%,9%,1111,27257,3.92%,96.08%,12171,14264,17,121,24,43,
0500000US28031,"Covington County, Mississippi",18810,9696,51.55%,48.45%,51.1,1727,9.18%,621,822,75,4177,1319,1253,568,10115,1821,4798,2141,1328,25.51%,11.38%,7%,418,17922,2.22%,97.78%,11047,6384,20,83,4,35,
0500000US28033,"DeSoto County, Mississippi",182256,94528,51.87%,48.13%,50.8,7998,4.39%,5189,6999,989,35987,13009,19404,10328,108897,29732,41176,20008,20393,22.59%,10.98%,11%,10161,175153,5.58%,94.42%,108466,55972,298,3023,137,632,
0500000US28035,"Forrest County, Mississippi",75162,39365,52.37%,47.63%,38.6,7229,9.62%,2227,7037,724,12164,5128,7473,5527,41509,13000,14391,12165,8197,19.15%,16.19%,11%,3258,74900,4.33%,95.67%,43121,28151,177,789,29,311,
0500000US28037,"Franklin County, Mississippi",7716,3981,51.59%,48.41%,54.3,532,6.89%,193,302,0,1946,641,503,174,4518,677,2139,943,503,27.72%,12.22%,7%,60,7615,0.78%,99.22%,4910,2563,2,8,0,12,
0500000US28039,"George County, Mississippi",24098,11943,49.56%,50.44%,52.9,2337,9.70%,752,694,168,5733,1778,1544,697,13370,2241,6485,2472,1712,26.91%,10.26%,7%,672,23678,2.79%,97.21%,20929,1774,85,77,1,41,
0500000US28041,"Greene County, Mississippi",13619,5510,40.46%,59.54%,41.8,1007,7.39%,401,531,1,3499,765,757,323,7652,1080,3900,1296,758,28.64%,9.52%,6%,171,13359,1.26%,98.74%,9809,3143,60,21,3,11,
0500000US28043,"Grenada County, Mississippi",20927,10692,51.09%,48.91%,41.2,2524,12.06%,362,771,23,4462,1572,1787,1080,11976,2867,4824,2343,1810,23.05%,11.20%,9%,310,21319,1.48%,98.52%,11258,9352,29,84,2,26,
0500000US28045,"Hancock County, Mississippi",47339,24420,51.59%,48.42%,56.8,2763,5.84%,1227,1509,182,9702,3310,5413,3540,31146,8953,10929,4819,5595,23.09%,10.18%,12%,1918,44135,4.05%,95.95%,37341,3911,244,424,9,166,
0500000US28047,"Harrison County, Mississippi",206169,104963,50.91%,49.09%,46.3,16458,7.98%,6589,8952,1900,38928,17229,19991,12531,122062,32522,45517,26181,21891,22.08%,12.70%,11%,13976,194645,6.78%,93.22%,125092,51143,786,5913,257,739,
0500000US28049,"Hinds County, Mississippi",235604,125622,53.32%,46.68%,35.3,19764,8.39%,7136,13384,2107,36321,15681,26350,19785,134612,46135,43457,29065,28457,18.44%,12.34%,12%,4564,223178,1.94%,98.06%,58012,157483,332,2157,43,562,
0500000US28051,"Holmes County, Mississippi",17414,9072,52.10%,47.90%,26.3,3259,18.71%,629,1218,96,4120,675,891,387,8597,1278,4749,1893,987,27.27%,10.87%,6%,112,16888,0.64%,99.36%,2359,14194,36,20,0,14,
0500000US28053,"Humphreys County, Mississippi",8198,4342,52.96%,47.04%,26.1,1238,15.10%,173,273,14,1664,592,413,370,3848,783,1837,865,427,22.41%,10.55%,5%,91,7694,1.11%,98.89%,1423,6072,13,10,0,8,
0500000US28055,"Issaquena County, Mississippi",1223,428,35.00%,65.00%,36.9,130,10.63%,30,15,0,356,72,9,25,661,34,386,87,9,31.56%,7.11%,1%,128,1210,10.47%,89.53%,440,748,1,5,0,1,
0500000US28057,"Itawamba County, Mississippi",23396,11635,49.73%,50.27%,49.4,788,3.37%,697,1661,44,5152,1281,1129,1056,12505,2185,5849,2942,1173,25.00%,12.57%,5%,384,23479,1.64%,98.36%,21129,1623,51,50,0,37,
0500000US28059,"Jackson County, Mississippi",142872,72394,50.67%,49.33%,46.3,10061,7.04%,4594,4926,738,28828,11407,14079,7946,86860,22025,33422,16333,14817,23.39%,11.43%,10%,10050,133202,7.03%,92.97%,92881,29713,572,3173,91,399,
0500000US28061,"Jasper County, Mississippi",16454,8404,51.08%,48.92%,45.8,1799,10.93%,542,643,67,4760,993,1226,460,9927,1686,5302,1636,1293,32.22%,9.94%,8%,169,16198,1.03%,98.97%,7541,8324,28,8,0,19,
0500000US28063,"Jefferson County, Mississippi",7129,3625,50.85%,49.15%,30.7,1165,16.34%,266,263,89,1601,149,433,491,3896,924,1867,412,522,26.19%,5.78%,7%,74,7186,1.04%,98.96%,891,6138,10,14,5,5,
0500000US28065,"Jefferson Davis County, Mississippi",11182,5870,52.50%,47.51%,45.4,1137,10.17%,298,355,31,2993,686,551,579,6700,1130,3291,1041,582,29.43%,9.31%,5%,101,11220,0.90%,99.10%,4330,6622,8,21,0,16,
0500000US28067,"Jones County, Mississippi",68307,35031,51.29%,48.72%,49.4,6033,8.83%,2280,2744,207,14158,5033,5606,3738,39034,9344,16438,7777,5813,24.06%,11.39%,9%,4139,63107,6.06%,93.94%,41676,19135,364,272,24,148,
0500000US28069,"Kemper County, Mississippi",9829,4947,50.33%,49.67%,36.5,1052,10.70%,256,733,482,2522,711,507,294,5395,801,2778,1444,989,28.26%,14.69%,10%,67,8921,0.68%,99.32%,2812,5486,460,6,1,13,
0500000US28071,"Lafayette County, Mississippi",54059,27915,51.64%,48.36%,39,7250,13.41%,1171,9891,1366,5921,3012,7640,6976,28595,14616,7092,12903,9006,13.12%,23.87%,17%,2142,53671,3.96%,96.04%,38766,11300,68,1685,24,130,
0500000US28073,"Lamar County, Mississippi",62693,32854,52.41%,47.60%,53.5,5590,8.92%,1418,2685,412,10925,3698,8933,5006,37430,13939,12343,6383,9345,19.69%,10.18%,15%,2362,61860,3.77%,96.23%,43865,14296,108,1091,50,206,
0500000US28075,"Lauderdale County, Mississippi",75557,38916,51.51%,48.50%,44.9,6742,8.92%,2312,2967,313,13902,6517,6549,4224,43544,10773,16214,9484,6862,21.46%,12.55%,9%,1789,71195,2.37%,97.63%,36534,31980,101,571,28,217,
0500000US28077,"Lawrence County, Mississippi",12595,6401,50.82%,49.18%,51.8,1234,9.80%,341,398,23,3233,1051,719,803,7278,1522,3574,1449,742,28.38%,11.50%,6%,207,11809,1.64%,98.36%,7807,3690,17,33,4,11,
0500000US28079,"Leake County, Mississippi",22791,11304,49.60%,50.40%,38.9,2804,12.30%,971,657,36,5410,1260,1439,922,11928,2361,6381,1917,1475,28.00%,8.41%,6%,1230,20045,5.40%,94.60%,10069,8189,1297,78,5,42,
0500000US28081,"Lee County, Mississippi",85304,44599,52.28%,47.72%,47.9,4057,4.76%,1819,3375,452,15048,5638,9171,6111,48463,15282,16867,9013,9623,19.77%,10.57%,11%,2828,80515,3.32%,96.68%,52854,24131,94,920,25,181,
0500000US28083,"Leflore County, Mississippi",28764,15213,52.89%,47.11%,26.6,4281,14.88%,577,1751,164,6541,1258,1927,1403,14727,3330,7118,3009,2091,24.75%,10.46%,7%,840,27499,2.92%,97.08%,5963,20809,15,205,0,26,
0500000US28085,"Lincoln County, Mississippi",34197,18108,52.95%,47.05%,51.1,3294,9.63%,542,1576,161,8944,2561,2130,1557,20251,3687,9486,4137,2291,27.74%,12.10%,7%,406,34501,1.19%,98.81%,22996,10484,63,163,8,77,
0500000US28087,"Lowndes County, Mississippi",58896,30929,52.52%,47.49%,45,4906,8.33%,1529,2930,492,13023,3521,5780,3628,34097,9408,14552,6451,6272,24.71%,10.95%,11%,1323,57556,2.25%,97.75%,29363,25885,110,514,16,110,
0500000US28089,"Madison County, Mississippi",105482,54863,52.01%,47.99%,52.8,5776,5.48%,2436,3679,1967,11694,5480,20406,14571,64253,34977,14130,9159,22373,13.40%,8.68%,21%,4117,105028,3.90%,96.10%,60273,38526,160,3167,13,300,
0500000US28091,"Marion County, Mississippi",24785,12823,51.74%,48.26%,48.7,2653,10.70%,591,643,22,6494,1806,1349,837,13980,2186,7085,2449,1371,28.59%,9.88%,6%,406,24035,1.64%,98.36%,15721,7583,42,65,0,46,
0500000US28093,"Marshall County, Mississippi",35502,17959,50.59%,49.41%,45.5,3924,11.05%,1546,1495,159,9105,1404,2338,1060,19857,3398,10651,2899,2497,30.00%,8.17%,7%,1540,32212,4.34%,95.66%,16284,14880,55,74,20,67,
0500000US28095,"Monroe County, Mississippi",35559,18649,52.45%,47.56%,49.6,2255,6.34%,1186,931,164,9408,2176,2611,1440,20520,4051,10594,3107,2775,29.79%,8.74%,8%,473,33707,1.33%,98.67%,22487,10311,50,67,3,44,
0500000US28097,"Montgomery County, Mississippi",9956,5383,54.07%,45.93%,37.3,1713,17.21%,202,293,33,2214,659,663,666,5604,1329,2416,952,696,24.27%,9.56%,7%,106,9716,1.06%,98.94%,5094,4364,9,24,0,8,
0500000US28099,"Neshoba County, Mississippi",29250,15268,52.20%,47.80%,44.8,3183,10.88%,869,1064,150,6108,1950,1488,1046,15084,2534,6977,3014,1638,23.85%,10.30%,6%,434,28653,1.48%,98.52%,16426,6380,4913,122,0,68,
0500000US28101,"Newton County, Mississippi",21215,11267,53.11%,46.89%,50.2,1953,9.21%,886,1163,44,4342,1909,1588,675,11635,2263,5228,3072,1632,24.64%,14.48%,8%,329,20962,1.55%,98.45%,12796,6447,1169,77,0,29,
0500000US28103,"Noxubee County, Mississippi",10566,5733,54.26%,45.74%,37.7,1438,13.61%,541,408,0,2370,868,593,219,5014,812,2911,1276,593,27.55%,12.08%,6%,172,10113,1.63%,98.37%,2639,7190,13,14,0,4,
0500000US28105,"Oktibbeha County, Mississippi",49593,24957,50.32%,49.68%,33.6,7900,15.93%,2126,11231,1422,5715,2237,5393,5677,23565,11070,7841,13468,6815,15.81%,27.16%,14%,1268,50520,2.56%,97.44%,29224,18228,93,1506,10,231,
0500000US28107,"Panola County, Mississippi",34079,17732,52.03%,47.97%,39,2556,7.50%,1129,1026,139,7007,2557,2353,1340,17425,3693,8136,3583,2492,23.87%,10.51%,7%,678,32530,1.99%,98.01%,15642,16035,52,62,4,35,
0500000US28109,"Pearl River County, Mississippi",55512,28103,50.63%,49.38%,55.5,3348,6.03%,1548,2270,129,12216,4784,3793,1809,33151,5602,13764,7054,3922,24.79%,12.71%,7%,2284,53861,4.11%,95.89%,44101,6666,256,275,0,165,
0500000US28111,"Perry County, Mississippi",11981,6103,50.94%,49.06%,50.8,990,8.26%,370,408,41,3595,722,524,306,6921,830,3965,1130,565,33.09%,9.43%,5%,154,11357,1.29%,98.71%,8868,2097,45,29,3,13,
0500000US28113,"Pike County, Mississippi",39365,20794,52.82%,47.18%,40.1,5639,14.32%,1262,1775,128,9008,2671,2402,1675,20999,4077,10270,4446,2530,26.09%,11.29%,6%,627,39697,1.59%,98.41%,16769,21457,113,254,7,109,
0500000US28115,"Pontotoc County, Mississippi",31996,16706,52.21%,47.79%,52.1,1619,5.06%,688,1141,174,5836,1778,2189,1642,16183,3831,6524,2919,2363,20.39%,9.12%,7%,2048,29136,6.40%,93.60%,23859,4208,56,55,5,67,
0500000US28117,"Prentiss County, Mississippi",25155,12962,51.53%,48.47%,50.6,1337,5.32%,514,1668,2,5703,2627,1412,973,14216,2385,6217,4295,1414,24.71%,17.07%,6%,405,24603,1.61%,98.39%,20166,3547,62,85,5,47,
0500000US28119,"Quitman County, Mississippi",7038,3751,53.30%,46.70%,28.7,1117,15.87%,230,304,24,1597,419,339,191,3541,530,1827,723,363,25.96%,10.27%,5%,21,6155,0.30%,99.70%,1484,4546,1,12,3,4,
0500000US28121,"Rankin County, Mississippi",154119,79785,51.77%,48.23%,53.7,6395,4.15%,4171,4600,1788,26693,11488,20750,11501,94954,32251,30864,16088,22538,20.03%,10.44%,15%,5067,151964,3.29%,96.71%,111990,32430,255,2260,94,447,
0500000US28123,"Scott County, Mississippi",28288,14094,49.82%,50.18%,47.9,2820,9.97%,910,921,23,6352,1409,1263,811,14286,2074,7262,2330,1286,25.67%,8.24%,5%,4148,23842,14.66%,85.34%,13145,9923,95,103,0,52,
0500000US28125,"Sharkey County, Mississippi",4427,2366,53.45%,46.56%,41.4,426,9.62%,132,110,3,1074,175,375,189,2430,564,1206,285,378,27.24%,6.44%,9%,61,3739,1.38%,98.62%,962,2671,0,14,3,1,
0500000US28127,"Simpson County, Mississippi",26818,13842,51.62%,48.39%,45.1,2081,7.76%,677,994,12,5176,2007,2304,885,14324,3189,5853,3001,2316,21.82%,11.19%,9%,386,25563,1.44%,98.56%,15928,8803,36,84,2,62,
0500000US28129,"Smith County, Mississippi",15919,8256,51.86%,48.14%,51,946,5.94%,707,207,14,4143,932,674,768,8707,1442,4850,1139,688,30.47%,7.15%,4%,198,14011,1.24%,98.76%,10582,3111,20,19,0,22,
0500000US28131,"Stone County, Mississippi",18282,9079,49.66%,50.34%,49.5,536,2.93%,480,974,10,4140,1251,1208,660,10241,1868,4620,2225,1218,25.27%,12.17%,7%,444,17889,2.43%,97.57%,13822,3239,79,89,9,72,
0500000US28133,"Sunflower County, Mississippi",25759,12178,47.28%,52.72%,27.2,2894,11.23%,761,1180,113,5606,1073,1729,1135,13020,2864,6367,2253,1842,24.72%,8.75%,7%,661,25310,2.57%,97.43%,6729,18077,19,84,0,37,
0500000US28135,"Tallahatchie County, Mississippi",14041,6086,43.34%,56.66%,28.5,1437,10.23%,480,682,97,3296,1144,702,412,7564,1114,3776,1826,799,26.89%,13.00%,6%,425,12290,3.03%,96.97%,4727,7390,4,10,3,0,
0500000US28137,"Tate County, Mississippi",28419,14706,51.75%,48.25%,50.3,1446,5.09%,699,1974,72,6281,2171,1766,1448,16094,3214,6980,4145,1838,24.56%,14.59%,6%,805,27259,2.83%,97.17%,18019,8231,52,63,1,81,
0500000US28139,"Tippah County, Mississippi",21976,11493,52.30%,47.70%,49,1700,7.74%,975,1045,10,4988,1585,1346,647,11238,1993,5963,2630,1356,27.13%,11.97%,6%,1118,20697,5.09%,94.91%,16609,3447,20,24,0,50,
0500000US28141,"Tishomingo County, Mississippi",19396,10027,51.70%,48.30%,54.9,1201,6.19%,480,805,59,5096,1558,1030,585,10891,1615,5576,2363,1089,28.75%,12.18%,6%,537,18313,2.77%,97.23%,17169,433,48,41,0,8,
0500000US28143,"Tunica County, Mississippi",9807,5186,52.88%,47.12%,32.7,1809,18.45%,201,157,0,2344,488,597,378,5142,975,2545,645,597,25.95%,6.58%,6%,191,9591,1.95%,98.05%,1853,7516,13,27,0,56,
0500000US28145,"Union County, Mississippi",28578,14688,51.40%,48.60%,50.1,1198,4.19%,637,1043,235,6103,1886,1817,863,14732,2680,6740,2929,2052,23.58%,10.25%,7%,1301,26476,4.55%,95.45%,21560,3950,27,109,0,76,
0500000US28147,"Walthall County, Mississippi",14423,7285,50.51%,49.49%,47.4,1242,8.61%,622,546,73,4178,727,843,661,7642,1504,4800,1273,916,33.28%,8.83%,6%,203,13681,1.41%,98.59%,7547,5706,42,48,8,50,
0500000US28149,"Warren County, Mississippi",46030,23985,52.11%,47.89%,42,5175,11.24%,1577,1601,160,8939,3440,4700,2465,26856,7165,10516,5041,4860,22.85%,10.95%,11%,876,43846,1.90%,98.10%,20909,21290,67,364,0,99,
0500000US28151,"Washington County, Mississippi",45072,24070,53.40%,46.60%,36.6,6371,14.14%,1648,1414,181,9451,2561,3652,2387,24087,6039,11099,3975,3833,24.63%,8.82%,9%,584,44338,1.30%,98.70%,11180,31919,48,302,5,69,
0500000US28153,"Wayne County, Mississippi",20344,10466,51.45%,48.56%,44.5,1902,9.35%,796,553,199,4559,817,1223,1498,10596,2721,5355,1370,1422,26.32%,6.73%,7%,343,19436,1.69%,98.31%,11313,7708,31,35,2,11,
0500000US28155,"Webster County, Mississippi",9727,5070,52.12%,47.88%,53.9,797,8.19%,271,259,67,2482,816,766,419,5609,1185,2753,1075,833,28.30%,11.05%,9%,155,9771,1.59%,98.41%,7691,1782,14,13,1,21,
0500000US28157,"Wilkinson County, Mississippi",8727,4021,46.08%,53.93%,29.5,1048,12.01%,369,81,0,2653,523,515,353,4735,868,3022,604,515,34.63%,6.92%,6%,70,8517,0.80%,99.20%,2525,5764,16,8,0,13,
0500000US28159,"Winston County, Mississippi",18116,9316,51.42%,48.58%,41.1,1659,9.16%,445,632,16,4751,1241,1373,656,10605,2029,5196,1873,1389,28.68%,10.34%,8%,226,17488,1.25%,98.75%,8856,8078,162,39,1,19,
0500000US28161,"Yalobusha County, Mississippi",12276,6390,52.05%,47.95%,47.7,1099,8.95%,299,378,70,3839,669,675,386,7333,1061,4138,1047,745,33.71%,8.53%,6%,163,12318,1.33%,98.67%,7331,4615,24,21,2,16,
0500000US28163,"Yazoo County, Mississippi",28511,12397,43.48%,56.52%,27.1,3809,13.36%,915,742,172,7247,1155,1574,709,14725,2283,8162,1897,1746,28.63%,6.65%,6%,1076,25667,3.77%,96.23%,9184,15812,50,115,6,36,
0500000US29001,"Adair County, Missouri",25468,13181,51.76%,48.25%,39.2,2768,10.87%,1099,4785,684,4810,1024,1975,2305,12493,4280,5909,5809,2659,23.20%,22.81%,10%,661,24653,2.60%,97.40%,21590,1265,41,685,13,50,
0500000US29003,"Andrew County, Missouri",17554,8770,49.96%,50.04%,56.6,619,3.53%,413,475,243,4450,834,2011,1240,11335,3251,4863,1309,2254,27.70%,7.46%,13%,391,17744,2.23%,97.77%,16756,138,40,89,0,44,
0500000US29005,"Atchison County, Missouri",5180,2599,50.17%,49.83%,57.4,246,4.75%,89,111,75,1578,165,651,221,3486,872,1667,276,726,32.18%,5.33%,14%,73,5232,1.41%,98.59%,4983,22,25,7,0,14,
0500000US29007,"Audrain County, Missouri",25336,13543,53.45%,46.55%,46.7,1532,6.05%,774,768,132,7539,1639,1639,867,15137,2506,8313,2407,1771,32.81%,9.50%,7%,731,24231,2.89%,97.11%,21450,1304,63,114,2,81,
0500000US29009,"Barry County, Missouri",35615,17909,50.29%,49.72%,57.7,2570,7.22%,1063,810,277,10374,1954,2563,1201,21101,3764,11437,2764,2840,32.11%,7.76%,8%,3333,31201,9.36%,90.64%,28058,102,316,808,70,81,
0500000US29011,"Barton County, Missouri",11732,5945,50.67%,49.33%,52.7,1031,8.79%,375,303,22,3271,555,1066,461,7007,1527,3646,858,1088,31.08%,7.31%,9%,266,11371,2.27%,97.73%,10367,27,145,37,2,15,
0500000US29013,"Bates County, Missouri",16282,8247,50.65%,49.35%,55.7,768,4.72%,578,303,83,5197,819,1141,524,9800,1665,5775,1122,1224,35.47%,6.89%,8%,335,15707,2.06%,97.94%,14799,155,92,48,9,21,
0500000US29015,"Benton County, Missouri",19305,9648,49.98%,50.02%,56.6,1500,7.77%,427,364,53,5859,1309,1122,1071,12888,2193,6286,1673,1175,32.56%,8.67%,6%,310,19084,1.61%,98.39%,17934,75,100,51,0,44,
0500000US29017,"Bollinger County, Missouri",12181,6050,49.67%,50.33%,51.6,614,5.04%,344,317,34,4043,490,585,354,7288,939,4387,807,619,36.02%,6.63%,5%,153,10414,1.26%,98.74%,9862,35,30,20,3,22,
0500000US29019,"Boone County, Missouri",179704,92472,51.46%,48.54%,44.8,14984,8.34%,6018,22160,4766,22402,8049,29384,22580,103074,51964,28420,30209,34150,15.81%,16.81%,19%,8052,175558,4.48%,95.52%,137771,17882,452,7772,120,990,
0500000US29021,"Buchanan County, Missouri",87904,43519,49.51%,50.49%,44.4,5996,6.82%,2782,3456,795,22278,3724,9023,4054,53081,13077,25060,7180,9818,28.51%,8.17%,11%,5600,79193,6.37%,93.63%,68391,4303,323,1048,426,237,
0500000US29023,"Butler County, Missouri",42570,21628,50.81%,49.19%,45.4,3434,8.07%,1464,1198,105,11422,2233,2342,1469,24633,3811,12886,3431,2447,30.27%,8.06%,6%,901,41229,2.12%,97.88%,35745,2463,198,304,12,100,
0500000US29025,"Caldwell County, Missouri",9052,4486,49.56%,50.44%,55.1,521,5.76%,337,210,50,2761,567,656,276,5587,932,3098,777,706,34.22%,8.58%,8%,151,8664,1.67%,98.33%,8172,65,34,26,7,23,
0500000US29027,"Callaway County, Missouri",44944,21985,48.92%,51.08%,51,1713,3.81%,1397,2244,366,10965,2734,4832,2414,27253,7246,12362,4978,5198,27.51%,11.08%,12%,965,43318,2.15%,97.85%,38453,1943,141,222,30,162,
0500000US29029,"Camden County, Missouri",45823,23102,50.42%,49.58%,54.5,2729,5.96%,1294,930,69,13134,2984,5319,2443,31934,7762,14428,3914,5388,31.49%,8.54%,12%,1355,41390,2.96%,97.04%,38714,247,177,221,28,128,
0500000US29031,"Cape Girardeau County, Missouri",78834,40751,51.69%,48.31%,47.6,5039,6.39%,2329,6983,1313,15992,2825,9850,6320,46469,16170,18321,9808,11163,23.24%,12.44%,14%,2234,79476,2.83%,97.17%,67393,6459,170,1300,14,202,
0500000US29033,"Carroll County, Missouri",8723,4417,50.64%,49.36%,57.3,394,4.52%,296,205,25,2681,434,722,366,5379,1088,2977,639,747,34.13%,7.33%,9%,132,8363,1.51%,98.49%,7906,97,15,15,0,6,
0500000US29035,"Carter County, Missouri",6085,3071,50.47%,49.53%,51.2,242,3.98%,119,289,0,2000,284,394,223,3508,617,2119,573,394,34.82%,9.42%,6%,97,5105,1.59%,98.41%,4794,11,17,18,1,3,
0500000US29037,"Cass County, Missouri",104687,53676,51.27%,48.73%,56.8,2412,2.30%,3235,2961,625,23707,6106,12888,6424,66910,19312,26942,9067,13513,25.74%,8.66%,13%,5583,102241,5.33%,94.67%,89406,4904,502,841,78,430,
0500000US29039,"Cedar County, Missouri",14144,6962,49.22%,50.78%,53.7,1172,8.29%,407,179,23,3922,959,816,527,8457,1343,4329,1138,839,30.61%,8.05%,6%,261,13927,1.85%,98.15%,12899,57,100,42,7,34,
0500000US29041,"Chariton County, Missouri",7449,3790,50.88%,49.12%,56.3,413,5.54%,163,195,19,2458,424,650,321,4773,971,2621,619,669,35.19%,8.31%,9%,101,7307,1.36%,98.64%,6925,144,15,3,3,1,
0500000US29043,"Christian County, Missouri",87324,44740,51.23%,48.77%,60.3,4271,4.89%,2299,2986,266,16611,5503,11300,6758,54390,18058,18910,8489,11566,21.65%,9.72%,13%,3012,85830,3.45%,96.55%,78890,597,468,624,68,240,
0500000US29045,"Clark County, Missouri",6783,3336,49.18%,50.82%,53.9,320,4.72%,159,142,18,2257,453,358,228,4152,586,2416,595,376,35.62%,8.77%,6%,50,6584,0.74%,99.26%,6337,21,9,12,0,10,
0500000US29047,"Clay County, Missouri",246480,125529,50.93%,49.07%,50.2,8428,3.42%,7977,7849,1977,46768,14428,36651,18227,155950,54878,54745,22277,38628,22.21%,9.04%,16%,18850,234485,7.65%,92.35%,193282,17853,1009,6059,1004,1012,
0500000US29049,"Clinton County, Missouri",20503,10348,50.47%,49.53%,57.6,1171,5.71%,713,422,73,6149,1165,2152,963,13157,3115,6862,1587,2225,33.47%,7.74%,11%,502,20682,2.45%,97.55%,19264,202,71,85,5,49,
0500000US29051,"Cole County, Missouri",76630,37904,49.46%,50.54%,49.9,3635,4.74%,1751,2803,978,15351,3805,12053,6743,48740,18796,17102,6608,13031,22.32%,8.62%,17%,2661,74618,3.47%,96.53%,61474,8041,175,965,56,305,
0500000US29053,"Cooper County, Missouri",17522,8526,48.66%,51.34%,48.3,981,5.60%,633,778,119,4378,1192,1808,875,10651,2683,5011,1970,1927,28.60%,11.24%,11%,322,16781,1.84%,98.16%,14730,920,53,67,6,62,
0500000US29055,"Crawford County, Missouri",23984,12213,50.92%,49.08%,52.7,1494,6.23%,988,475,11,6844,1538,1401,593,13702,1994,7832,2013,1412,32.66%,8.39%,6%,482,22574,2.01%,97.99%,20980,148,107,81,14,39,
0500000US29057,"Dade County, Missouri",7571,3719,49.12%,50.88%,55.5,365,4.82%,233,186,7,2389,350,626,130,4819,756,2622,536,633,34.63%,7.08%,8%,135,7434,1.78%,98.22%,6995,34,50,24,0,0,
0500000US29059,"Dallas County, Missouri",16841,8877,52.71%,47.29%,57.2,1017,6.04%,503,256,0,5674,418,700,627,10051,1327,6177,674,700,36.68%,4.00%,4%,320,16751,1.90%,98.10%,15696,44,92,25,15,43,
0500000US29061,"Daviess County, Missouri",8294,4129,49.78%,50.22%,57.6,255,3.07%,225,151,33,2288,394,771,376,4856,1147,2513,545,804,30.30%,6.57%,10%,113,8317,1.36%,98.64%,7924,31,27,16,10,7,
0500000US29063,"DeKalb County, Missouri",11872,4606,38.80%,61.20%,44.1,362,3.05%,390,232,76,3918,656,959,426,7755,1385,4308,888,1035,36.29%,7.48%,9%,227,10802,1.91%,98.09%,9653,672,30,42,2,24,
0500000US29065,"Dent County, Missouri",15518,7822,50.41%,49.59%,52.5,908,5.85%,336,379,10,4318,814,973,672,9256,1645,4654,1193,983,29.99%,7.69%,6%,271,14150,1.75%,98.25%,13203,52,61,54,7,47,
0500000US29067,"Douglas County, Missouri",13335,6627,49.70%,50.30%,60.3,841,6.31%,462,217,5,4079,588,870,385,7980,1255,4541,805,875,34.05%,6.04%,7%,239,11339,1.79%,98.21%,10602,35,74,24,0,28,
0500000US29069,"Dunklin County, Missouri",29657,15594,52.58%,47.42%,45,3047,10.27%,1286,629,32,7935,1535,1598,1136,15590,2734,9221,2164,1630,31.09%,7.30%,5%,2042,26241,6.89%,93.11%,21629,3176,70,78,4,65,
0500000US29071,"Franklin County, Missouri",103629,52005,50.18%,49.82%,54.6,4470,4.31%,3142,3013,630,23536,7817,9761,5548,64346,15309,26678,10830,10391,25.74%,10.45%,10%,2205,102477,2.13%,97.87%,95680,880,291,532,31,283,
0500000US29073,"Gasconade County, Missouri",14673,7344,50.05%,49.95%,58.6,453,3.09%,344,351,73,4092,860,1467,807,9359,2274,4436,1211,1540,30.23%,8.25%,10%,189,14605,1.29%,98.71%,13705,18,25,51,9,24,
0500000US29075,"Gentry County, Missouri",6576,3390,51.55%,48.45%,52.3,400,6.08%,209,128,17,1849,320,640,259,3817,899,2058,448,657,31.30%,6.81%,10%,90,6072,1.37%,98.63%,5851,15,6,9,1,9,
0500000US29077,"Greene County, Missouri",291574,149706,51.34%,48.66%,48.7,18933,6.49%,8102,24456,4218,53709,15286,38232,21952,177058,60184,61811,39742,42450,21.20%,13.63%,15%,14392,284523,4.94%,95.06%,246368,9987,1735,6182,375,1101,
0500000US29079,"Grundy County, Missouri",9885,5008,50.66%,49.34%,48.4,695,7.03%,281,352,73,2464,672,819,382,5596,1201,2745,1024,892,27.77%,10.36%,9%,241,9567,2.44%,97.56%,9121,50,33,54,8,15,
0500000US29081,"Harrison County, Missouri",8427,4248,50.41%,49.59%,51,508,6.03%,328,108,39,2735,589,589,324,5267,913,3063,697,628,36.35%,8.27%,7%,168,7989,1.99%,98.01%,7618,32,30,23,3,10,
0500000US29083,"Henry County, Missouri",21854,11108,50.83%,49.17%,51.8,1436,6.57%,757,340,55,6466,1326,1494,944,13599,2438,7223,1666,1549,33.05%,7.62%,7%,573,21373,2.62%,97.38%,19800,177,89,91,6,67,
0500000US29085,"Hickory County, Missouri",9452,4857,51.39%,48.61%,52.1,620,6.56%,210,151,44,3471,595,417,203,6390,620,3681,746,461,38.94%,7.89%,5%,132,8147,1.40%,98.60%,7648,11,42,15,0,28,
0500000US29087,"Holt County, Missouri",4374,2227,50.91%,49.09%,57.3,154,3.52%,121,70,19,1470,200,394,195,3010,589,1591,270,413,36.37%,6.17%,9%,67,4156,1.53%,98.47%,3992,4,30,2,0,18,
0500000US29089,"Howard County, Missouri",10022,4939,49.28%,50.72%,47.8,567,5.66%,261,845,100,2328,477,1018,862,5816,1880,2589,1322,1118,25.83%,13.19%,11%,208,9943,2.08%,97.92%,8826,542,34,27,3,46,
0500000US29091,"Howell County, Missouri",40130,20611,51.36%,48.64%,53.9,4627,11.53%,1178,1066,86,10984,2165,2788,1977,23651,4765,12162,3231,2874,30.31%,8.05%,7%,896,38854,2.23%,97.77%,35972,180,265,217,17,109,
0500000US29093,"Iron County, Missouri",10150,5133,50.57%,49.43%,52.4,686,6.76%,261,276,18,2972,638,610,268,5984,878,3233,914,628,31.85%,9.00%,6%,177,9360,1.74%,98.26%,8602,136,60,34,2,4,
0500000US29095,"Jackson County, Missouri",700733,362123,51.68%,48.32%,43.2,43235,6.17%,21021,22482,7840,134361,35583,96970,56515,436119,153485,155382,58065,104810,22.17%,8.29%,15%,77785,639419,11.10%,88.90%,419542,156542,2713,14981,1727,3083,
0500000US29097,"Jasper County, Missouri",120528,61837,51.31%,48.70%,49.3,9066,7.52%,4395,4297,830,27727,5709,12985,5036,69269,18021,32122,10006,13815,26.65%,8.30%,11%,11377,111384,9.44%,90.56%,96388,2260,1894,1491,440,388,
0500000US29099,"Jefferson County, Missouri",224777,112988,50.27%,49.73%,54.2,9063,4.03%,6509,7129,1129,50254,19461,22372,10509,140530,32881,56763,26590,23501,25.25%,11.83%,10%,5552,221187,2.47%,97.53%,203287,2295,617,1839,71,622,
0500000US29101,"Johnson County, Missouri",53948,26253,48.66%,51.34%,47.8,2890,5.36%,3039,6519,644,9495,2975,5437,3902,29313,9339,12534,9494,6081,23.23%,17.60%,11%,2595,51418,4.81%,95.19%,44415,2309,259,821,210,203,
0500000US29103,"Knox County, Missouri",3948,1964,49.75%,50.25%,49.9,220,5.57%,63,190,9,1198,206,242,167,2285,409,1261,396,251,31.94%,10.03%,6%,23,3721,0.58%,99.42%,3573,20,5,18,0,6,
0500000US29105,"Laclede County, Missouri",35680,18198,51.00%,49.00%,57.8,1919,5.38%,1265,720,236,10514,1656,2614,1015,20809,3629,11779,2376,2850,33.01%,6.66%,8%,955,35084,2.68%,97.32%,32482,262,197,190,17,71,
0500000US29107,"Lafayette County, Missouri",32697,16149,49.39%,50.61%,51,1315,4.02%,1023,941,48,9939,1317,2873,1860,20532,4733,10962,2258,2921,33.53%,6.91%,9%,1047,31937,3.20%,96.80%,29256,671,138,115,12,58,
0500000US29109,"Lawrence County, Missouri",38241,19324,50.53%,49.47%,54.3,2717,7.10%,1731,681,73,9965,1493,2914,1134,21565,4048,11696,2174,2987,30.58%,5.68%,8%,2987,35014,7.81%,92.19%,32401,134,333,171,40,91,
0500000US29111,"Lewis County, Missouri",9898,4824,48.74%,51.26%,49.4,725,7.32%,230,813,43,2881,418,595,339,5638,934,3111,1231,638,31.43%,12.44%,6%,165,9867,1.67%,98.33%,9315,185,30,22,0,10,
0500000US29113,"Lincoln County, Missouri",57590,28761,49.94%,50.06%,54.4,3610,6.27%,1857,1665,243,15569,4123,5193,1693,34529,6886,17426,5788,5436,30.26%,10.05%,9%,1541,58033,2.68%,97.32%,53051,1072,193,235,27,177,
0500000US29115,"Linn County, Missouri",12004,6189,51.56%,48.44%,56.2,776,6.46%,389,235,76,3790,646,991,538,7384,1529,4179,881,1067,34.81%,7.34%,9%,289,11585,2.41%,97.59%,11027,67,31,22,6,25,
0500000US29117,"Livingston County, Missouri",14969,8295,55.42%,44.59%,51.8,548,3.66%,443,527,70,4212,1045,1341,670,9298,2011,4655,1572,1411,31.10%,10.50%,9%,239,14318,1.60%,98.40%,13368,315,47,87,5,19,
0500000US29119,"McDonald County, Missouri",22882,11251,49.17%,50.83%,56.1,1522,6.65%,687,523,100,6480,944,1253,480,12018,1733,7167,1467,1353,31.32%,6.41%,6%,2818,20485,12.32%,87.68%,16667,421,493,376,868,82,
0500000US29121,"Macon County, Missouri",15154,7640,50.42%,49.58%,51.1,704,4.65%,526,497,92,4870,751,1230,593,9330,1823,5396,1248,1322,35.61%,8.24%,9%,276,14933,1.82%,98.18%,13778,299,25,84,4,37,
0500000US29123,"Madison County, Missouri",12176,6151,50.52%,49.48%,56.9,481,3.95%,325,343,58,3427,827,762,430,7280,1192,3752,1170,820,30.81%,9.61%,7%,342,12284,2.81%,97.19%,11555,54,49,41,0,22,
0500000US29125,"Maries County, Missouri",8791,4393,49.97%,50.03%,54.3,909,10.34%,263,174,35,2489,583,631,368,5314,999,2752,757,666,31.30%,8.61%,8%,134,8298,1.52%,98.48%,7796,23,42,7,0,16,
0500000US29127,"Marion County, Missouri",28572,14712,51.49%,48.51%,53.2,2136,7.48%,989,1034,199,6854,1500,3029,1744,17219,4773,7843,2534,3228,27.45%,8.87%,11%,516,28009,1.81%,98.19%,24930,1363,67,165,16,96,
0500000US29129,"Mercer County, Missouri",3623,1829,50.48%,49.52%,51.3,136,3.75%,139,96,6,1003,199,304,160,2146,464,1142,295,310,31.52%,8.14%,9%,155,3383,4.28%,95.72%,3291,0,8,0,0,7,
0500000US29131,"Miller County, Missouri",25369,12760,50.30%,49.70%,57.5,1345,5.30%,896,728,67,6957,1345,2231,1087,15303,3318,7853,2073,2298,30.96%,8.17%,9%,466,24256,1.84%,98.16%,22908,117,113,64,24,45,
0500000US29133,"Mississippi County, Missouri",13328,6067,45.52%,54.48%,42.7,1150,8.63%,371,217,52,4115,451,780,413,7398,1193,4486,668,832,33.66%,5.01%,6%,223,12354,1.67%,98.33%,8814,3060,33,20,0,52,
0500000US29135,"Moniteau County, Missouri",15907,7549,47.46%,52.54%,55,734,4.61%,394,282,70,4457,489,1503,531,9146,2034,4851,771,1573,30.50%,4.85%,10%,864,14609,5.43%,94.57%,13688,282,40,42,16,27,
0500000US29137,"Monroe County, Missouri",8630,4252,49.27%,50.73%,55.6,705,8.17%,188,290,8,2975,434,648,206,5551,854,3163,724,656,36.65%,8.39%,8%,159,8507,1.84%,98.16%,7902,177,32,31,1,17,
0500000US29139,"Montgomery County, Missouri",11414,5774,50.59%,49.41%,56.9,863,7.56%,282,302,36,3642,612,911,413,7038,1324,3924,914,947,34.38%,8.01%,8%,229,11093,2.01%,97.99%,10444,101,22,50,5,22,
0500000US29141,"Morgan County, Missouri",20438,10277,50.28%,49.72%,52.9,1630,7.98%,428,333,10,5701,973,1172,654,11307,1826,6129,1306,1182,29.99%,6.39%,6%,446,20560,2.18%,97.82%,19298,126,105,61,8,57,
0500000US29143,"New Madrid County, Missouri",17275,9053,52.41%,47.60%,47.7,1449,8.39%,590,322,94,5605,904,865,580,9797,1445,6195,1226,959,35.86%,7.10%,6%,253,16181,1.46%,98.54%,12610,2731,25,62,1,27,
0500000US29145,"Newton County, Missouri",58288,29344,50.34%,49.66%,58.5,2821,4.84%,1938,2024,227,13894,3453,5859,2710,34848,8569,15832,5477,6086,27.16%,9.40%,10%,3607,55041,6.19%,93.81%,47551,523,1351,798,790,138,
0500000US29147,"Nodaway County, Missouri",22199,11077,49.90%,50.10%,40.6,1695,7.64%,981,4901,199,4732,880,1943,1462,11608,3405,5713,5781,2142,25.74%,26.04%,10%,427,20814,1.92%,98.08%,19290,363,31,390,2,46,
0500000US29149,"Oregon County, Missouri",10561,5364,50.79%,49.21%,57.9,1239,11.73%,460,92,30,3390,364,607,509,6414,1116,3850,456,637,36.45%,4.32%,6%,117,8518,1.11%,98.89%,7990,25,65,8,0,14,
0500000US29151,"Osage County, Missouri",13613,6576,48.31%,51.69%,61.6,428,3.14%,442,547,112,4070,1051,1412,481,8484,1893,4512,1598,1524,33.14%,11.74%,11%,125,13149,0.92%,99.08%,12688,24,28,3,10,10,
0500000US29153,"Ozark County, Missouri",9138,4635,50.72%,49.28%,58.2,809,8.85%,269,162,10,2725,419,471,334,5575,805,2994,581,481,32.76%,6.36%,5%,109,8444,1.19%,98.81%,8000,19,38,14,5,41,
0500000US29155,"Pemiscot County, Missouri",16330,8709,53.33%,46.67%,43.7,1885,11.54%,627,377,54,4717,656,775,511,8491,1286,5344,1033,829,32.73%,6.33%,5%,415,15246,2.54%,97.46%,10176,4297,29,35,4,35,
0500000US29157,"Perry County, Missouri",19227,9808,51.01%,48.99%,56.9,647,3.37%,479,600,188,5525,1057,1778,746,11435,2524,6004,1657,1966,31.23%,8.62%,10%,383,18573,1.99%,98.01%,17657,102,29,123,0,20,
0500000US29159,"Pettis County, Missouri",42421,21397,50.44%,49.56%,52.9,2581,6.08%,1358,1793,103,9919,2974,3186,2010,24636,5196,11277,4767,3289,26.58%,11.24%,8%,4016,38964,9.47%,90.53%,34751,1353,159,294,120,119,
0500000US29161,"Phelps County, Missouri",44587,21147,47.43%,52.57%,47.4,4068,9.12%,1458,4693,843,8414,2491,4590,3739,24988,8329,9872,7184,5433,22.14%,16.11%,12%,1259,43379,2.82%,97.18%,37941,1028,231,1506,20,230,
0500000US29163,"Pike County, Missouri",18158,8320,45.82%,54.18%,46,1438,7.92%,703,219,59,6420,627,1315,573,10915,1888,7123,846,1374,39.23%,4.66%,8%,434,17153,2.39%,97.61%,15383,942,40,23,7,32,
0500000US29165,"Platte County, Missouri",102848,52093,50.65%,49.35%,53.9,2520,2.45%,2418,3676,1206,16032,5447,18834,11347,67425,30181,18450,9123,20040,17.94%,8.87%,19%,7161,99557,6.96%,93.04%,81426,8135,391,2721,695,459,
0500000US29167,"Polk County, Missouri",32031,16299,50.89%,49.12%,49.9,1970,6.15%,940,2328,268,7827,1457,2930,1316,18311,4246,8767,3785,3198,27.37%,11.82%,10%,791,30728,2.47%,97.53%,28682,242,190,131,4,61,
0500000US29169,"Pulaski County, Missouri",52359,22593,43.15%,56.85%,45.8,2450,4.68%,5993,4076,659,8469,3416,4958,3199,27418,8157,14462,7492,5617,27.62%,14.31%,11%,6079,47876,11.61%,88.39%,35865,6039,334,1776,402,220,
0500000US29171,"Putnam County, Missouri",4746,2376,50.06%,49.94%,54.6,197,4.15%,122,120,3,1465,294,405,279,3112,684,1587,414,408,33.44%,8.72%,9%,112,4569,2.36%,97.64%,4446,11,5,0,0,0,
0500000US29173,"Ralls County, Missouri",10258,5152,50.22%,49.78%,60.1,626,6.10%,303,246,63,3451,527,701,425,6628,1126,3754,773,764,36.60%,7.54%,7%,96,10259,0.94%,99.06%,9713,114,26,17,4,41,
0500000US29175,"Randolph County, Missouri",24769,11896,48.03%,51.97%,44.9,1081,4.36%,692,1231,74,6314,1867,2123,949,15166,3072,7006,3098,2197,28.29%,12.51%,9%,572,24144,2.31%,97.69%,21271,1351,102,95,9,75,
0500000US29177,"Ray County, Missouri",22900,11578,50.56%,49.44%,54.9,806,3.52%,814,504,96,7533,1021,1597,668,14198,2265,8347,1525,1693,36.45%,6.66%,7%,580,22578,2.53%,97.47%,20893,227,133,76,8,53,
0500000US29179,"Reynolds County, Missouri",6274,2993,47.71%,52.30%,56.3,345,5.50%,210,123,3,1730,368,551,172,3697,723,1940,491,554,30.92%,7.83%,9%,99,5997,1.58%,98.42%,5669,33,23,18,2,0,
0500000US29181,"Ripley County, Missouri",13484,6835,50.69%,49.31%,48.6,825,6.12%,310,301,41,3837,615,694,335,7781,1029,4147,916,735,30.75%,6.79%,5%,127,10552,0.94%,99.06%,9885,31,44,28,1,1,
0500000US29183,"St. Charles County, Missouri",398472,202565,50.84%,49.17%,56.5,8468,2.13%,9752,16705,4167,63194,24636,70442,40473,258641,110915,72946,41341,74609,18.31%,10.37%,19%,16011,389251,4.02%,95.98%,335879,20672,623,11068,199,1377,
0500000US29185,"St. Clair County, Missouri",9455,4717,49.89%,50.11%,53.5,453,4.79%,278,176,48,2777,613,667,349,6071,1016,3055,789,715,32.31%,8.34%,8%,178,9106,1.88%,98.12%,8567,26,63,19,7,23,
0500000US29186,"Ste. Genevieve County, Missouri",17887,8833,49.38%,50.62%,59.5,467,2.61%,348,481,214,4791,1288,1298,994,11612,2292,5139,1769,1512,28.73%,9.89%,8%,269,18210,1.50%,98.50%,17127,320,54,29,2,19,
0500000US29187,"St. Francois County, Missouri",66653,31044,46.58%,53.42%,47.9,3359,5.04%,2286,1946,50,17775,4025,3826,2777,40266,6603,20061,5971,3876,30.10%,8.96%,6%,1089,65833,1.63%,98.37%,59474,2645,192,403,21,188,
0500000US29189,"St. Louis County, Missouri",996179,523364,52.54%,47.46%,48.4,40897,4.11%,26001,33565,15853,147118,53727,174212,133186,650162,307398,173119,87292,190065,17.38%,8.76%,19%,37178,966947,3.73%,96.27%,624703,245168,1474,48552,264,4736,
0500000US29195,"Saline County, Missouri",22932,11505,50.17%,49.83%,44.4,1318,5.75%,794,1720,137,5500,926,2342,1022,12643,3364,6294,2646,2479,27.45%,11.54%,11%,2830,20503,12.34%,87.66%,17473,1149,68,175,397,233,
0500000US29197,"Schuyler County, Missouri",4550,2339,51.41%,48.59%,49.1,225,4.95%,104,105,30,1414,417,185,95,2688,280,1518,522,215,33.36%,11.47%,5%,47,3985,1.03%,98.97%,3864,0,1,15,1,9,
0500000US29199,"Scotland County, Missouri",4923,2551,51.82%,48.18%,54.5,136,2.76%,104,115,42,1248,218,269,188,2450,457,1352,333,311,27.46%,6.76%,6%,35,4681,0.71%,99.29%,4537,6,5,5,1,0,
0500000US29201,"Scott County, Missouri",38538,19778,51.32%,48.68%,48.2,3136,8.14%,1122,1224,226,9971,1631,3184,1996,22201,5180,11093,2855,3410,28.78%,7.41%,9%,935,37124,2.43%,97.57%,30595,4476,84,149,2,97,
0500000US29203,"Shannon County, Missouri",8207,4149,50.55%,49.45%,53.7,1096,13.35%,347,56,0,2653,508,511,337,4813,848,3000,564,511,36.55%,6.87%,6%,141,6890,1.72%,98.28%,6451,3,37,13,0,3,
0500000US29205,"Shelby County, Missouri",5975,2874,48.10%,51.90%,57.3,408,6.83%,171,112,13,1756,248,549,253,3724,802,1927,360,562,32.25%,6.03%,9%,117,5986,1.96%,98.04%,5749,20,20,1,0,9,
0500000US29207,"Stoddard County, Missouri",29255,15128,51.71%,48.29%,50.6,1751,5.99%,951,717,48,8707,1304,1750,769,16383,2519,9658,2021,1798,33.01%,6.91%,6%,566,28106,1.93%,98.07%,26610,298,67,90,2,33,
0500000US29209,"Stone County, Missouri",31875,16226,50.91%,49.10%,60.2,1431,4.49%,987,528,156,8230,2463,3366,1529,21931,4895,9217,2991,3522,28.92%,9.38%,11%,782,30294,2.45%,97.55%,28296,79,215,115,20,84,
0500000US29211,"Sullivan County, Missouri",6163,3139,50.93%,49.07%,50.4,443,7.19%,182,169,34,2062,281,417,239,3698,656,2244,450,451,36.41%,7.30%,7%,1054,4945,17.10%,82.90%,4507,208,26,29,1,14,
0500000US29213,"Taney County, Missouri",55563,29116,52.40%,47.60%,54.2,2160,3.89%,1422,2559,601,13329,3211,5633,2572,34949,8205,14751,5770,6234,26.55%,10.38%,11%,4329,51737,7.79%,92.21%,46468,837,407,608,187,182,
0500000US29215,"Texas County, Missouri",25518,12270,48.08%,51.92%,53.9,2678,10.49%,959,543,86,7109,1160,1647,1031,15296,2678,8068,1703,1733,31.62%,6.67%,7%,515,23972,2.02%,97.98%,21992,780,142,65,6,46,
0500000US29217,"Vernon County, Missouri",20560,10574,51.43%,48.57%,53.2,1212,5.89%,503,747,167,5612,1376,1442,964,12125,2406,6115,2123,1609,29.74%,10.33%,8%,426,19281,2.07%,97.93%,17966,110,131,103,18,52,
0500000US29219,"Warren County, Missouri",35090,17720,50.50%,49.50%,59.2,2284,6.51%,1019,1005,145,8908,2182,3124,1571,21609,4695,9927,3187,3269,28.29%,9.08%,9%,1400,34132,3.99%,96.01%,31103,718,116,143,0,111,
0500000US29221,"Washington County, Missouri",24819,11968,48.22%,51.78%,52.2,2062,8.31%,668,882,33,6762,1253,1335,630,13685,1965,7430,2135,1368,29.94%,8.60%,6%,227,23287,0.91%,99.09%,21378,610,78,40,1,53,
0500000US29223,"Wayne County, Missouri",13058,6651,50.93%,49.07%,53.9,1022,7.83%,580,112,5,4167,534,680,272,7808,952,4747,646,685,36.35%,4.95%,5%,155,10819,1.19%,98.81%,10093,50,67,23,5,2,
0500000US29225,"Webster County, Missouri",39127,19150,48.94%,51.06%,58.5,2437,6.23%,851,1360,73,9506,2110,2863,1611,21970,4474,10357,3470,2936,26.47%,8.87%,8%,790,38295,2.02%,97.98%,35893,194,243,141,9,86,
0500000US29227,"Worth County, Missouri",2001,1006,50.28%,49.73%,56,114,5.70%,66,62,7,635,113,175,88,1298,263,701,175,182,35.03%,8.75%,9%,25,1948,1.25%,98.75%,1887,0,4,4,5,0,
0500000US29229,"Wright County, Missouri",18256,9373,51.34%,48.66%,51.9,1207,6.61%,466,387,40,5073,1065,942,404,9943,1346,5539,1452,982,30.34%,7.95%,5%,370,17818,2.03%,97.97%,16654,111,73,48,5,59,
0500000US29510,"St. Louis city, Missouri",304709,157017,51.53%,48.47%,31.1,27959,9.18%,7797,12100,5250,52868,13848,44747,36652,193998,81399,60665,25948,49997,19.91%,8.52%,16%,15405,286173,5.06%,94.94%,129368,128993,614,12205,88,1773,
0500000US30001,"Beaverhead County, Montana",9454,4728,50.01%,49.99%,55.4,486,5.14%,368,767,120,1927,591,1314,788,6118,2102,2295,1358,1434,24.28%,14.36%,15%,431,8940,4.56%,95.44%,8330,24,120,37,3,40,
0500000US30003,"Big Horn County, Montana",13302,6705,50.41%,49.59%,45.1,1511,11.36%,517,399,101,2529,832,907,495,6733,1402,3046,1231,1008,22.90%,9.25%,8%,515,12609,3.87%,96.13%,3407,11,8627,44,9,3,
0500000US30005,"Blaine County, Montana",6698,3417,51.02%,48.99%,44.8,960,14.33%,169,261,11,1163,506,767,250,3724,1017,1332,767,778,19.89%,11.45%,12%,158,6886,2.36%,97.64%,2942,10,3621,13,0,35,
0500000US30007,"Broadwater County, Montana",6080,2910,47.86%,52.14%,50,210,3.45%,233,146,18,1129,609,896,288,4115,1184,1362,755,914,22.40%,12.42%,15%,200,6574,3.29%,96.71%,6149,17,44,5,0,24,
0500000US30009,"Carbon County, Montana",10689,5258,49.19%,50.81%,54.6,310,2.90%,264,142,45,2559,589,1662,926,7832,2588,2823,731,1707,26.41%,6.84%,16%,261,10212,2.44%,97.56%,9603,13,97,21,0,45,
0500000US30011,"Carter County, Montana",1305,615,47.13%,52.87%,65,39,2.99%,4,52,12,297,112,175,32,904,207,301,164,187,23.07%,12.57%,14%,11,1404,0.84%,99.16%,1341,0,7,1,0,4,
0500000US30013,"Cascade County, Montana",81576,40323,49.43%,50.57%,50.2,4501,5.52%,3073,3034,629,17533,5535,10323,4907,51521,15230,20606,8569,10952,25.26%,10.50%,13%,4012,80402,4.92%,95.08%,68794,1085,3725,908,105,441,
0500000US30015,"Chouteau County, Montana",5731,2878,50.22%,49.78%,59.9,329,5.74%,152,203,23,1422,370,928,226,3695,1154,1574,573,951,27.46%,10.00%,17%,159,5736,2.77%,97.23%,4172,10,1347,18,0,10,
0500000US30017,"Custer County, Montana",11563,5847,50.57%,49.43%,53.3,550,4.76%,331,326,63,2380,969,1556,731,7726,2287,2711,1295,1619,23.45%,11.20%,14%,362,11505,3.13%,96.87%,10701,71,192,52,7,13,
0500000US30019,"Daniels County, Montana",1705,794,46.57%,53.43%,57.5,40,2.35%,21,15,0,461,137,224,77,1245,301,482,152,224,28.27%,8.91%,13%,49,1612,2.87%,97.13%,1467,0,34,13,0,0,
0500000US30021,"Dawson County, Montana",8824,4145,46.97%,53.03%,59.6,321,3.64%,300,146,39,1871,1259,1122,486,5985,1608,2171,1405,1161,24.60%,15.92%,13%,288,8652,3.26%,96.74%,7969,38,166,57,1,30,
0500000US30023,"Deer Lodge County, Montana",9153,4319,47.19%,52.81%,42.7,798,8.72%,334,203,11,2722,489,1079,361,6481,1440,3056,692,1090,33.39%,7.56%,12%,260,9161,2.84%,97.16%,8514,23,222,33,2,15,
0500000US30025,"Fallon County, Montana",2975,1514,50.89%,49.11%,56.8,132,4.44%,117,36,12,749,343,223,84,1870,307,866,379,235,29.11%,12.74%,8%,63,2986,2.12%,97.88%,2858,5,27,5,2,1,
0500000US30027,"Fergus County, Montana",11167,5453,48.83%,51.17%,54.4,1029,9.21%,260,292,42,2568,923,1655,569,7731,2224,2828,1215,1697,25.32%,10.88%,15%,225,11221,2.01%,97.99%,10566,21,124,38,0,33,
0500000US30029,"Flathead County, Montana",102001,51069,50.07%,49.93%,55.2,3379,3.31%,3306,2507,486,20545,7398,15695,7547,68455,23242,23851,9905,16181,23.38%,9.71%,16%,3329,101028,3.26%,96.74%,93416,269,931,703,77,459,
0500000US30031,"Gallatin County, Montana",111401,53605,48.12%,51.88%,50.2,5423,4.87%,4591,9531,3093,12708,4819,23709,13150,69338,36859,17299,14350,26802,15.53%,12.88%,24%,5895,113065,5.29%,94.71%,104003,493,922,1389,91,549,
0500000US30033,"Garfield County, Montana",1051,526,50.05%,49.95%,64.6,22,2.09%,25,34,0,294,67,120,30,692,150,319,101,120,30.35%,9.61%,11%,14,1159,1.33%,98.67%,1125,0,9,2,1,0,
0500000US30035,"Glacier County, Montana",13706,6941,50.64%,49.36%,39.1,1869,13.64%,466,519,70,2913,865,1193,706,7195,1899,3379,1384,1263,24.65%,10.10%,9%,301,13477,2.20%,97.80%,3496,19,9085,39,16,10,
0500000US30037,"Golden Valley County, Montana",814,404,49.63%,50.37%,62.9,60,7.37%,13,17,0,234,49,103,36,590,139,247,66,103,30.34%,8.11%,13%,35,788,4.30%,95.70%,724,7,1,0,1,11,
0500000US30039,"Granite County, Montana",3325,1604,48.24%,51.76%,52,209,6.29%,60,89,7,734,265,596,179,2322,775,794,354,603,23.88%,10.65%,18%,85,3224,2.56%,97.44%,3066,0,24,3,0,13,
0500000US30041,"Hill County, Montana",16422,8235,50.15%,49.85%,47.5,1326,8.07%,382,928,161,3093,1045,2088,643,9442,2731,3475,1973,2249,21.16%,12.01%,14%,500,15809,3.04%,96.96%,11020,44,3671,79,8,24,
0500000US30043,"Jefferson County, Montana",12069,5924,49.08%,50.92%,62.4,433,3.59%,238,319,116,2411,1007,2132,955,8323,3087,2649,1326,2248,21.95%,10.99%,19%,291,11794,2.41%,97.59%,10926,15,161,49,0,43,
0500000US30045,"Judith Basin County, Montana",1968,891,45.27%,54.73%,62.4,117,5.95%,16,35,11,411,245,317,44,1415,361,427,280,328,21.70%,14.23%,17%,49,1974,2.49%,97.51%,1883,8,1,4,2,13,
0500000US30047,"Lake County, Montana",30383,15393,50.66%,49.34%,53.7,2491,8.20%,760,887,122,5488,2185,4363,2220,19525,6583,6248,3072,4485,20.56%,10.11%,15%,1168,29966,3.84%,96.16%,20373,64,6632,138,21,108,
0500000US30049,"Lewis and Clark County, Montana",68714,34705,50.51%,49.49%,51.8,2978,4.33%,1719,2395,683,11274,4425,12789,7763,46263,20552,12993,6820,13472,18.91%,9.93%,20%,2599,68374,3.78%,96.22%,62063,266,1233,551,44,287,
0500000US30051,"Liberty County, Montana",2455,1378,56.13%,43.87%,55.6,312,12.71%,89,0,17,330,176,278,106,1263,384,419,176,295,17.07%,7.17%,12%,13,1946,0.53%,99.47%,1856,2,10,6,0,6,
0500000US30053,"Lincoln County, Montana",19845,10038,50.58%,49.42%,57.9,1105,5.57%,373,315,14,5714,1342,2195,804,13948,2999,6087,1657,2209,30.67%,8.35%,11%,561,19116,2.83%,97.17%,17725,32,204,100,13,86,
0500000US30055,"McCone County, Montana",1826,844,46.22%,53.78%,64.5,10,0.55%,17,77,10,446,167,170,39,1234,209,463,244,180,25.36%,13.36%,10%,32,1697,1.75%,98.25%,1592,1,23,8,2,10,
0500000US30057,"Madison County, Montana",8530,4211,49.37%,50.63%,60.1,209,2.45%,103,171,31,1835,866,1684,601,6492,2285,1938,1037,1715,22.72%,12.16%,20%,239,8384,2.80%,97.20%,7955,11,34,30,6,40,
0500000US30059,"Meagher County, Montana",1795,841,46.85%,53.15%,57.7,78,4.35%,0,43,12,548,59,281,79,1295,360,548,102,293,30.53%,5.68%,16%,46,1881,2.56%,97.44%,1781,12,4,2,0,8,
0500000US30061,"Mineral County, Montana",4330,2047,47.28%,52.73%,52.6,234,5.40%,111,27,5,1176,307,561,165,3028,726,1287,334,566,29.72%,7.71%,13%,147,4388,3.39%,96.61%,4044,10,63,21,5,18,
0500000US30063,"Missoula County, Montana",119062,59658,50.11%,49.89%,45.4,6736,5.66%,4221,8715,2077,16736,7230,22378,13297,77270,35675,20957,15945,24455,17.60%,13.39%,21%,6004,111918,5.04%,94.96%,99953,706,3009,1423,122,509,
0500000US30065,"Musselshell County, Montana",4682,2330,49.77%,50.24%,63.6,151,3.23%,137,27,63,1443,254,401,219,3209,620,1580,281,464,33.75%,6.00%,10%,146,4584,3.12%,96.88%,4274,4,87,22,5,12,
0500000US30067,"Park County, Montana",16513,8263,50.04%,49.96%,55.8,897,5.43%,279,439,145,3551,1117,2823,1256,12136,4079,3830,1556,2968,23.19%,9.42%,18%,510,16681,3.09%,96.91%,15636,62,142,75,0,51,
0500000US30069,"Petroleum County, Montana",464,223,48.06%,51.94%,64.6,27,5.82%,10,10,0,135,41,77,17,350,94,145,51,77,31.25%,10.99%,17%,5,491,1.08%,98.92%,466,0,0,0,0,0,
0500000US30071,"Phillips County, Montana",4032,1981,49.13%,50.87%,57.1,93,2.31%,177,28,2,1101,204,331,192,2644,523,1278,232,333,31.70%,5.75%,8%,112,4105,2.78%,97.22%,3492,5,329,15,0,26,
0500000US30073,"Pondera County, Montana",5911,2986,50.52%,49.48%,50.9,547,9.25%,102,262,17,1205,464,782,193,3751,975,1307,726,799,22.11%,12.28%,14%,97,5801,1.64%,98.36%,4644,4,891,25,11,10,
0500000US30075,"Powder River County, Montana",1634,859,52.57%,47.43%,70.6,81,4.96%,37,23,42,383,108,204,92,1167,296,420,131,246,25.70%,8.02%,15%,35,1659,2.14%,97.86%,1529,5,31,0,0,10,
0500000US30077,"Powell County, Montana",6843,2542,37.15%,62.85%,51,390,5.70%,261,197,7,2214,427,592,347,4796,939,2475,624,599,36.17%,9.12%,9%,161,6785,2.35%,97.65%,6016,64,402,23,3,17,
0500000US30079,"Prairie County, Montana",1162,581,50.00%,50.00%,63.8,60,5.16%,37,1,0,234,120,145,91,745,236,271,121,145,23.32%,10.41%,12%,33,1055,2.84%,97.16%,982,2,13,7,0,0,
0500000US30081,"Ravalli County, Montana",43424,21882,50.39%,49.61%,59.2,2229,5.13%,1142,776,168,9542,3514,5854,3379,29825,9233,10684,4290,6022,24.60%,9.88%,14%,1584,42590,3.65%,96.35%,39695,88,323,241,29,335,
0500000US30083,"Richland County, Montana",11097,5348,48.19%,51.81%,52,467,4.21%,463,188,102,2832,780,1032,338,6973,1370,3295,968,1134,29.69%,8.72%,10%,605,10886,5.45%,94.55%,9892,61,165,121,5,46,
0500000US30085,"Roosevelt County, Montana",11091,5641,50.86%,49.14%,36.3,1632,14.71%,375,341,8,2062,690,903,296,5700,1199,2437,1031,911,21.97%,9.30%,8%,239,10555,2.15%,97.85%,3587,32,6150,47,0,22,
0500000US30087,"Rosebud County, Montana",9065,4527,49.94%,50.06%,52.4,703,7.76%,330,292,42,1809,700,648,372,5172,1020,2139,992,690,23.60%,10.94%,8%,234,8095,2.58%,97.42%,4768,20,2908,32,2,28,
0500000US30089,"Sanders County, Montana",11804,5706,48.34%,51.66%,56.5,637,5.40%,295,148,12,3533,881,1387,340,8167,1727,3828,1029,1399,32.43%,8.72%,12%,346,12054,2.93%,97.07%,10732,23,441,56,3,76,
0500000US30091,"Sheridan County, Montana",3389,1652,48.75%,51.25%,57.5,109,3.22%,148,70,25,890,124,418,196,2266,614,1038,194,443,30.63%,5.72%,13%,107,3432,3.16%,96.84%,3170,14,61,13,0,3,
0500000US30093,"Silver Bow County, Montana",34895,17070,48.92%,51.08%,46.5,3101,8.89%,1632,1624,235,8259,1862,4717,1856,22315,6573,9891,3486,4952,28.35%,9.99%,14%,1638,33495,4.69%,95.31%,31081,126,480,214,20,134,
0500000US30095,"Stillwater County, Montana",9562,4756,49.74%,50.26%,60.8,227,2.37%,320,259,3,2307,593,1275,523,6386,1798,2627,852,1278,27.47%,8.91%,13%,269,8694,2.81%,97.19%,8110,13,85,22,0,33,
0500000US30097,"Sweet Grass County, Montana",3676,1854,50.44%,49.57%,63.3,118,3.21%,209,13,32,918,251,429,143,2519,572,1127,264,461,30.66%,7.18%,13%,98,3580,2.67%,97.33%,3332,8,24,15,3,8,
0500000US30099,"Teton County, Montana",6127,3116,50.86%,49.14%,58.6,432,7.05%,214,125,54,1359,341,780,280,3860,1060,1573,466,834,25.67%,7.61%,14%,85,6141,1.39%,98.61%,5655,19,101,15,6,38,
0500000US30101,"Toole County, Montana",4812,2158,44.85%,55.15%,48.2,128,2.66%,163,132,6,1251,250,578,205,3055,783,1414,382,584,29.38%,7.94%,12%,178,4793,3.70%,96.30%,4179,32,338,36,0,20,
0500000US30103,"Treasure County, Montana",614,298,48.53%,51.47%,69,27,4.40%,12,0,2,168,41,125,21,472,146,180,41,127,29.32%,6.68%,21%,31,731,5.05%,94.95%,688,1,15,3,1,0,
0500000US30105,"Valley County, Montana",7424,3671,49.45%,50.55%,54.4,216,2.91%,214,142,58,1802,490,829,190,4931,1019,2016,632,887,27.16%,8.51%,12%,174,7404,2.34%,97.66%,6353,15,674,19,0,29,
0500000US30107,"Wheatland County, Montana",2138,1125,52.62%,47.38%,59.3,330,15.43%,32,10,14,565,106,232,71,1359,303,597,116,246,27.92%,5.43%,12%,68,2001,3.18%,96.82%,1850,3,11,3,0,7,
0500000US30109,"Wibaux County, Montana",1037,526,50.72%,49.28%,65.8,20,1.93%,0,3,28,268,83,136,36,676,172,268,86,164,25.84%,8.29%,16%,27,910,2.60%,97.40%,859,2,5,2,2,5,
0500000US30111,"Yellowstone County, Montana",160390,81262,50.67%,49.34%,52.9,5916,3.69%,5076,5123,907,32175,10047,25002,11076,104216,36078,37251,15170,25909,23.23%,9.46%,16%,10115,154616,6.31%,93.69%,136514,1187,6546,1279,211,576,
0500000US31001,"Adams County, Nebraska",31541,15807,50.12%,49.88%,51.8,1481,4.70%,666,2181,274,5512,2329,3214,2007,18539,5221,6178,4510,3488,19.59%,14.30%,11%,3659,27546,11.60%,88.40%,25779,247,119,415,9,67,
0500000US31003,"Antelope County, Nebraska",6315,3148,49.85%,50.15%,56.3,255,4.04%,118,174,69,1501,728,565,223,4016,788,1619,902,634,25.64%,14.28%,10%,221,6074,3.50%,96.50%,5899,22,16,22,0,3,
0500000US31005,"Arthur County, Nebraska",439,234,53.30%,46.70%,60.5,22,5.01%,6,8,0,82,47,54,20,294,74,88,55,54,20.05%,12.53%,12%,12,422,2.73%,97.27%,400,3,0,0,0,0,
0500000US31007,"Banner County, Nebraska",645,325,50.39%,49.61%,82.1,20,3.10%,3,5,0,111,78,85,39,452,124,114,83,85,17.67%,12.87%,13%,51,623,7.91%,92.09%,600,0,5,2,0,0,
0500000US31009,"Blaine County, Nebraska",467,221,47.32%,52.68%,70.9,2,0.43%,0,3,0,151,43,50,37,354,87,151,46,50,32.33%,9.85%,11%,11,420,2.36%,97.64%,397,1,0,1,0,0,
0500000US31011,"Boone County, Nebraska",5228,2640,50.50%,49.50%,62.1,126,2.41%,131,206,13,1364,508,464,226,3430,690,1495,714,477,28.60%,13.66%,9%,183,5196,3.50%,96.50%,5057,21,15,7,0,6,
0500000US31013,"Box Butte County, Nebraska",10845,5354,49.37%,50.63%,58.9,589,5.43%,299,140,14,2438,691,1080,252,6849,1332,2737,831,1094,25.24%,7.66%,10%,1246,9596,11.49%,88.51%,8681,66,293,71,0,17,
0500000US31015,"Boyd County, Nebraska",1882,958,50.90%,49.10%,65.7,72,3.83%,26,37,21,629,183,186,80,1401,266,655,220,207,34.80%,11.69%,11%,33,1777,1.75%,98.25%,1723,0,11,0,0,4,
0500000US31017,"Brown County, Nebraska",2887,1497,51.85%,48.15%,58.5,85,2.94%,42,81,42,775,242,347,166,2024,513,817,323,389,28.30%,11.19%,13%,176,2727,6.10%,93.90%,2629,2,7,6,0,2,
0500000US31019,"Buffalo County, Nebraska",49594,24852,50.11%,49.89%,49.3,2261,4.56%,2043,4359,467,7598,2885,6752,3523,27994,10275,9641,7244,7219,19.44%,14.61%,15%,5062,45022,10.21%,89.79%,42108,600,149,660,33,94,
0500000US31021,"Burt County, Nebraska",6503,3324,51.12%,48.89%,55.2,413,6.35%,178,123,42,1627,567,813,223,4220,1036,1805,690,855,27.76%,10.61%,13%,172,6550,2.64%,97.36%,6197,19,72,35,17,9,
0500000US31023,"Butler County, Nebraska",7997,4020,50.27%,49.73%,58.7,393,4.91%,290,232,25,1973,778,1042,273,5114,1315,2263,1010,1067,28.30%,12.63%,13%,482,7887,6.03%,93.97%,7626,28,22,9,1,23,
0500000US31025,"Cass County, Nebraska",26022,12874,49.47%,50.53%,60.6,567,2.18%,660,709,185,5148,2374,3521,1734,16913,5255,5808,3083,3706,22.32%,11.85%,14%,988,25610,3.80%,96.20%,24261,102,87,103,8,91,
0500000US31027,"Cedar County, Nebraska",8483,4189,49.38%,50.62%,63.3,115,1.36%,190,292,67,1983,874,812,383,5328,1195,2173,1166,879,25.62%,13.75%,10%,186,8194,2.19%,97.81%,8010,25,13,9,2,3,
0500000US31029,"Chase County, Nebraska",3707,1931,52.09%,47.91%,63.8,53,1.43%,37,126,34,688,235,416,167,2337,583,725,361,450,19.56%,9.74%,12%,562,3331,15.16%,84.84%,3209,20,2,11,0,2,
0500000US31031,"Cherry County, Nebraska",5801,2881,49.66%,50.34%,57.6,143,2.47%,190,49,126,1326,539,710,257,3920,967,1516,588,836,26.13%,10.14%,14%,148,5307,2.55%,97.45%,4772,11,271,7,0,7,
0500000US31033,"Cheyenne County, Nebraska",9428,4729,50.16%,49.84%,52.5,552,5.85%,271,218,54,2071,915,1273,410,6253,1683,2342,1133,1327,24.84%,12.02%,14%,751,8717,7.97%,92.03%,8239,51,29,75,0,39,
0500000US31035,"Clay County, Nebraska",6193,3037,49.04%,50.96%,64.2,170,2.75%,180,163,48,1513,662,594,252,3950,846,1693,825,642,27.34%,13.32%,10%,523,5581,8.45%,91.55%,5372,8,13,10,0,14,
0500000US31037,"Colfax County, Nebraska",10681,4595,43.02%,56.98%,51.2,530,4.96%,208,287,200,1816,690,696,284,4606,980,2024,977,896,18.95%,9.15%,8%,4993,5589,46.75%,53.25%,5018,375,26,50,2,16,
0500000US31039,"Cuming County, Nebraska",8882,4388,49.40%,50.60%,64.1,171,1.93%,175,350,54,2281,677,1026,374,5464,1400,2456,1027,1080,27.65%,11.56%,12%,1112,7901,12.52%,87.48%,7638,21,26,18,9,23,
0500000US31041,"Custer County, Nebraska",10788,5387,49.94%,50.07%,59.6,482,4.47%,190,339,110,2421,865,1360,488,7084,1848,2611,1204,1470,24.20%,11.16%,14%,388,10157,3.60%,96.40%,9804,48,32,19,2,14,
0500000US31043,"Dakota County, Nebraska",20124,10085,50.11%,49.89%,55.3,1463,7.27%,609,758,324,4150,1245,1327,488,9514,1815,4759,2003,1651,23.65%,9.95%,8%,8811,12771,43.78%,56.22%,9347,1603,526,602,154,33,
0500000US31045,"Dawes County, Nebraska",8685,4363,50.24%,49.76%,46.6,455,5.24%,396,1014,268,1170,448,1094,945,5017,2039,1566,1462,1362,18.03%,16.83%,16%,328,7871,3.78%,96.22%,6943,164,322,53,6,21,
0500000US31047,"Dawson County, Nebraska",23638,11573,48.96%,51.04%,58.2,1019,4.31%,952,609,139,4629,1539,1912,623,12027,2535,5581,2148,2051,23.61%,9.09%,9%,8643,15468,36.56%,63.44%,13529,1187,44,192,41,60,
0500000US31049,"Deuel County, Nebraska",1770,931,52.60%,47.40%,62.1,65,3.67%,37,73,4,382,133,202,68,1170,270,419,206,206,23.67%,11.64%,12%,100,1738,5.65%,94.35%,1686,1,7,6,0,7,
0500000US31051,"Dixon County, Nebraska",5682,2818,49.60%,50.41%,59.5,159,2.80%,104,232,27,1261,393,645,215,3334,860,1365,625,672,24.02%,11.00%,12%,796,4810,14.01%,85.99%,4643,17,19,17,0,8,
0500000US31053,"Dodge County, Nebraska",36565,18431,50.41%,49.59%,54.4,1639,4.48%,930,1739,448,8767,2633,3047,1759,21648,4806,9697,4372,3495,26.52%,11.96%,10%,6083,31084,16.64%,83.36%,29501,215,133,183,12,93,
0500000US31055,"Douglas County, Nebraska",565739,286767,50.69%,49.31%,48.6,25024,4.42%,15134,22786,7353,78201,29697,96033,52455,335474,148488,93335,52483,103386,16.50%,9.28%,18%,80820,503706,14.29%,85.71%,381427,63706,2653,27593,410,2310,
0500000US31057,"Dundy County, Nebraska",1928,936,48.55%,51.45%,57,54,2.80%,24,67,44,312,158,225,143,1152,368,336,225,269,17.43%,11.67%,14%,103,1551,5.34%,94.66%,1491,7,9,1,3,4,
0500000US31059,"Fillmore County, Nebraska",5542,2807,50.65%,49.35%,60,126,2.27%,150,130,42,1346,624,593,322,3806,915,1496,754,635,26.99%,13.61%,11%,177,5374,3.19%,96.81%,5181,20,19,13,1,0,
0500000US31061,"Franklin County, Nebraska",2970,1496,50.37%,49.63%,62.2,95,3.20%,96,49,18,808,282,276,133,2082,409,904,331,294,30.44%,11.14%,10%,82,2807,2.76%,97.24%,2741,6,3,14,0,4,
0500000US31063,"Frontier County, Nebraska",2636,1275,48.37%,51.63%,59.4,102,3.87%,109,134,41,504,254,277,139,1719,416,613,388,318,23.25%,14.72%,12%,81,2438,3.07%,96.93%,2337,17,6,0,3,4,
0500000US31065,"Furnas County, Nebraska",4712,2381,50.53%,49.47%,65.3,137,2.91%,89,117,53,1097,408,480,157,3002,637,1186,525,533,25.17%,11.14%,11%,220,4416,4.67%,95.33%,4235,9,19,6,0,4,
0500000US31067,"Gage County, Nebraska",21548,10700,49.66%,50.34%,52.6,1116,5.18%,644,623,71,5327,1881,2279,856,13676,3135,5971,2504,2350,27.71%,11.62%,11%,635,21069,2.95%,97.05%,20053,122,78,99,1,43,
0500000US31069,"Garden County, Nebraska",1916,953,49.74%,50.26%,58.6,69,3.60%,5,28,5,466,163,252,84,1370,336,471,191,257,24.58%,9.97%,13%,88,1786,4.59%,95.41%,1722,3,3,2,1,10,
0500000US31071,"Garfield County, Nebraska",2081,974,46.80%,53.20%,68.3,39,1.87%,74,28,22,424,180,376,66,1445,442,498,208,398,23.93%,10.00%,19%,24,1789,1.15%,98.85%,1752,3,0,0,0,1,
0500000US31073,"Gosper County, Nebraska",2001,955,47.73%,52.27%,66.2,24,1.20%,25,2,17,452,193,327,131,1491,458,477,195,344,23.84%,9.75%,17%,95,1798,4.75%,95.25%,1746,2,4,11,0,0,
0500000US31075,"Grant County, Nebraska",691,308,44.57%,55.43%,58,39,5.64%,7,52,2,173,35,86,20,427,106,180,87,88,26.05%,12.59%,13%,12,599,1.74%,98.26%,576,5,12,1,0,1,
0500000US31077,"Greeley County, Nebraska",2361,1183,50.11%,49.89%,60.2,175,7.41%,29,73,11,599,227,201,83,1555,284,628,300,212,26.60%,12.71%,9%,52,2136,2.20%,97.80%,2098,1,3,6,1,10,
0500000US31079,"Hall County, Nebraska",61338,30294,49.39%,50.61%,52.9,2818,4.59%,1982,1745,388,11842,3539,5681,2680,33631,8361,13824,5284,6069,22.54%,8.61%,10%,19181,43714,31.27%,68.73%,39420,1815,215,688,25,187,
0500000US31081,"Hamilton County, Nebraska",9219,4652,50.46%,49.54%,65.1,145,1.57%,323,227,35,1925,901,1060,503,6130,1563,2248,1128,1095,24.38%,12.24%,12%,320,9109,3.47%,96.53%,8796,27,30,14,0,19,
0500000US31083,"Harlan County, Nebraska",3380,1692,50.06%,49.94%,61.4,224,6.63%,121,38,62,640,520,451,114,2218,565,761,558,513,22.51%,16.51%,15%,90,2983,2.66%,97.34%,2907,1,5,11,0,0,
0500000US31085,"Hayes County, Nebraska",889,437,49.16%,50.84%,61.2,31,3.49%,17,24,0,179,117,112,10,602,122,196,141,112,22.05%,15.86%,13%,63,793,7.09%,92.91%,760,0,4,2,0,0,
0500000US31087,"Hitchcock County, Nebraska",2788,1352,48.49%,51.51%,54.7,213,7.64%,81,39,4,614,219,206,105,1842,311,695,258,210,24.93%,9.25%,8%,87,2529,3.12%,96.88%,2462,0,0,2,4,1,
0500000US31089,"Holt County, Nebraska",10123,5025,49.64%,50.36%,61.6,133,1.31%,288,336,40,2210,1143,1234,450,6533,1684,2498,1479,1274,24.68%,14.61%,13%,521,9606,5.15%,94.85%,9325,41,38,50,1,12,
0500000US31091,"Hooker County, Nebraska",741,367,49.53%,50.47%,48.5,33,4.45%,0,28,37,174,66,113,15,484,128,174,94,150,23.48%,12.69%,20%,11,700,1.48%,98.52%,663,4,1,1,0,0,
0500000US31093,"Howard County, Nebraska",6428,3176,49.41%,50.59%,65.4,129,2.01%,87,228,47,1751,472,763,209,4297,972,1838,700,810,28.59%,10.89%,13%,146,6329,2.27%,97.73%,6154,13,14,12,1,8,
0500000US31095,"Jefferson County, Nebraska",7102,3677,51.77%,48.23%,57.7,297,4.18%,169,125,80,1960,664,734,214,4686,948,2129,789,814,29.98%,11.11%,11%,361,6879,5.08%,94.92%,6558,20,40,15,0,20,
0500000US31097,"Johnson County, Nebraska",5118,2043,39.92%,60.08%,45.7,132,2.58%,271,123,7,1670,307,491,203,3261,694,1941,430,498,37.92%,8.40%,10%,629,4661,12.29%,87.71%,4101,311,52,76,0,8,
0500000US31099,"Kearney County, Nebraska",6588,3322,50.43%,49.58%,60.9,321,4.87%,195,204,39,1249,546,891,283,4177,1174,1444,750,930,21.92%,11.38%,14%,385,6303,5.84%,94.16%,6064,3,14,12,2,11,
0500000US31101,"Keith County, Nebraska",8048,3948,49.06%,50.94%,57.6,381,4.73%,112,239,22,1687,677,820,334,5371,1154,1799,916,842,22.35%,11.38%,10%,750,7585,9.32%,90.68%,7232,15,19,38,7,16,
0500000US31103,"Keya Paha County, Nebraska",875,417,47.66%,52.34%,61.1,10,1.14%,30,7,0,187,91,102,53,582,155,217,98,102,24.80%,11.20%,12%,20,749,2.29%,97.71%,734,0,1,0,0,0,
0500000US31105,"Kimball County, Nebraska",3576,1748,48.88%,51.12%,49.1,135,3.78%,63,58,6,1021,299,248,101,2376,349,1084,357,254,30.31%,9.98%,7%,262,3172,7.33%,92.67%,3026,1,24,15,0,9,
0500000US31107,"Knox County, Nebraska",8400,4259,50.70%,49.30%,61.9,280,3.33%,171,267,58,2063,861,799,349,5414,1148,2234,1128,857,26.60%,13.43%,10%,185,8206,2.20%,97.80%,6967,16,943,28,3,13,
0500000US31109,"Lancaster County, Nebraska",315976,157372,49.81%,50.20%,48.2,17226,5.45%,10436,26713,7657,41447,22559,48821,29400,183395,78221,51883,49272,56478,16.42%,15.59%,18%,25844,296764,8.18%,91.82%,251962,13369,1707,13975,170,1351,
0500000US31111,"Lincoln County, Nebraska",35042,17776,50.73%,49.27%,56.5,1518,4.33%,1020,986,78,7097,3677,3425,1839,22766,5264,8117,4663,3503,23.16%,13.31%,10%,3011,31665,8.59%,91.41%,29643,382,147,325,6,111,
0500000US31113,"Logan County, Nebraska",896,421,46.99%,53.01%,63.6,57,6.36%,5,42,0,145,86,124,9,546,133,150,128,124,16.74%,14.29%,14%,23,693,2.57%,97.43%,665,0,0,4,0,0,
0500000US31115,"Loup County, Nebraska",690,325,47.10%,52.90%,67.8,21,3.04%,12,40,7,178,77,81,22,492,103,190,117,88,27.54%,16.96%,13%,18,589,2.61%,97.39%,565,0,0,1,0,0,
0500000US31117,"McPherson County, Nebraska",420,213,50.71%,49.29%,76.9,17,4.05%,9,10,8,88,83,63,18,315,81,97,93,71,23.10%,22.14%,17%,3,396,0.71%,99.29%,378,0,4,2,0,1,
0500000US31119,"Madison County, Nebraska",35023,17569,50.16%,49.84%,51,2063,5.89%,1109,1683,264,7078,3508,3764,1658,20745,5422,8187,5191,4028,23.38%,14.82%,12%,5514,30071,15.74%,84.26%,27823,404,366,445,7,118,
0500000US31121,"Merrick County, Nebraska",7826,3949,50.46%,49.54%,54.2,428,5.47%,129,307,43,2060,641,702,242,5183,944,2189,948,745,27.97%,12.11%,10%,372,7296,4.75%,95.25%,6941,41,25,29,3,0,
0500000US31123,"Morrill County, Nebraska",4711,2281,48.42%,51.58%,54.2,231,4.90%,105,97,45,1107,315,534,184,2906,718,1212,412,579,25.73%,8.75%,12%,648,3907,13.76%,86.24%,3722,19,38,20,0,11,
0500000US31125,"Nance County, Nebraska",3525,1777,50.41%,49.59%,58.8,107,3.04%,68,153,8,899,434,266,195,2352,461,967,587,274,27.43%,16.65%,8%,60,3320,1.70%,98.30%,3202,4,8,5,0,1,
0500000US31127,"Nemaha County, Nebraska",6978,3478,49.84%,50.16%,52.4,274,3.93%,213,650,12,1373,438,882,401,4170,1283,1586,1088,894,22.73%,15.59%,13%,208,6866,2.98%,97.02%,6538,56,27,31,0,13,
0500000US31129,"Nuckolls County, Nebraska",4204,2126,50.57%,49.43%,61.7,216,5.14%,119,83,16,968,454,499,220,2841,719,1087,537,515,25.86%,12.77%,12%,118,3977,2.81%,97.19%,3835,4,4,3,0,14,
0500000US31131,"Otoe County, Nebraska",15965,8098,50.72%,49.28%,58.2,906,5.67%,569,431,140,3707,1201,1869,895,10048,2764,4276,1632,2009,26.78%,10.22%,13%,1262,14650,7.90%,92.10%,13867,82,36,86,0,35,
0500000US31133,"Pawnee County, Nebraska",2640,1361,51.55%,48.45%,53.4,218,8.26%,33,109,18,720,216,177,116,1576,293,753,325,195,28.52%,12.31%,7%,39,2505,1.48%,98.52%,2446,4,7,0,1,3,
0500000US31135,"Perkins County, Nebraska",2889,1386,47.98%,52.03%,71,85,2.94%,40,41,3,501,162,448,94,1827,542,541,203,451,18.73%,7.03%,16%,146,2712,5.05%,94.95%,2620,10,3,3,3,2,
0500000US31137,"Phelps County, Nebraska",9050,4535,50.11%,49.89%,59.3,441,4.87%,203,284,84,1704,763,1128,468,5773,1596,1907,1047,1212,21.07%,11.57%,13%,551,8417,6.09%,93.91%,8140,34,20,28,1,24,
0500000US31139,"Pierce County, Nebraska",7132,3610,50.62%,49.38%,62.7,341,4.78%,129,298,20,1641,858,926,270,4634,1196,1770,1156,946,24.82%,16.21%,13%,142,7175,1.99%,98.01%,6950,30,17,12,2,14,
0500000US31141,"Platte County, Nebraska",33250,16207,48.74%,51.26%,56.1,541,1.63%,1070,991,192,6495,2855,3392,1731,19726,5123,7565,3846,3584,22.75%,11.57%,11%,7252,27044,21.81%,78.19%,25583,346,98,198,9,101,
0500000US31143,"Polk County, Nebraska",5208,2661,51.09%,48.91%,60,274,5.26%,169,85,21,1259,503,544,154,3275,698,1428,588,565,27.42%,11.29%,11%,259,4955,4.97%,95.03%,4751,8,14,2,1,10,
0500000US31145,"Red Willow County, Nebraska",10725,5415,50.49%,49.51%,49.7,314,2.93%,388,327,169,2167,974,1207,471,6744,1678,2555,1301,1376,23.82%,12.13%,13%,687,10015,6.41%,93.59%,9536,112,37,39,12,14,
0500000US31147,"Richardson County, Nebraska",7913,3933,49.70%,50.30%,56.3,493,6.23%,258,118,14,2186,621,757,320,5331,1077,2444,739,771,30.89%,9.34%,10%,155,7716,1.96%,98.04%,7096,15,223,35,0,11,
0500000US31149,"Rock County, Nebraska",1430,667,46.64%,53.36%,63.8,34,2.38%,39,56,12,308,138,226,69,960,295,347,194,238,24.27%,13.57%,17%,20,1242,1.40%,98.60%,1219,3,1,0,0,2,
0500000US31151,"Saline County, Nebraska",14221,7127,50.12%,49.88%,53.6,749,5.27%,390,1042,111,2783,1148,1262,462,7373,1724,3173,2190,1373,22.31%,15.40%,10%,4067,10225,28.60%,71.40%,9363,130,41,277,46,25,
0500000US31153,"Sarpy County, Nebraska",183956,91866,49.94%,50.06%,57.2,4515,2.45%,5773,6742,1802,25297,11948,30924,16887,112792,47811,31070,18690,32726,16.89%,10.16%,18%,20055,170549,10.90%,89.10%,147064,7232,553,4726,224,716,
0500000US31155,"Saunders County, Nebraska",21356,10572,49.50%,50.50%,59.4,608,2.85%,508,707,225,4354,1920,2847,1202,13749,4049,4862,2627,3072,22.77%,12.30%,14%,585,21693,2.74%,97.26%,20703,72,77,86,5,71,
0500000US31157,"Scotts Bluff County, Nebraska",35884,18578,51.77%,48.23%,51.5,1536,4.28%,1224,1054,199,7041,2397,3889,1665,21339,5554,8265,3451,4088,23.03%,9.62%,11%,8203,27881,22.86%,77.14%,25711,234,466,277,25,100,
0500000US31159,"Seward County, Nebraska",17217,8464,49.16%,50.84%,58.5,557,3.24%,492,1491,191,3083,1615,2355,987,10311,3342,3575,3106,2546,20.76%,18.04%,15%,496,17113,2.88%,97.12%,16382,102,44,57,6,44,
0500000US31161,"Sheridan County, Nebraska",5215,2709,51.95%,48.05%,58.2,425,8.15%,86,156,26,1278,366,568,190,3311,758,1364,522,594,26.16%,10.01%,11%,222,4905,4.26%,95.74%,4095,15,522,29,2,10,
0500000US31163,"Sherman County, Nebraska",3015,1509,50.05%,49.95%,57.8,127,4.21%,68,67,40,714,233,327,150,2050,477,782,300,367,25.94%,9.95%,12%,82,2877,2.72%,97.28%,2774,0,16,5,2,1,
0500000US31165,"Sioux County, Nebraska",1298,690,53.16%,46.84%,65.9,51,3.93%,58,44,13,232,73,171,56,810,227,290,117,184,22.34%,9.01%,14%,43,1092,3.31%,96.69%,1055,0,2,4,2,4,
0500000US31167,"Stanton County, Nebraska",5946,2895,48.69%,51.31%,58.2,275,4.62%,127,160,23,1269,734,610,185,3816,795,1396,894,633,23.48%,15.04%,11%,352,5490,5.92%,94.08%,5215,22,27,18,7,11,
0500000US31169,"Thayer County, Nebraska",5000,2520,50.40%,49.60%,60.3,196,3.92%,109,100,71,1204,506,529,212,3294,741,1313,606,600,26.26%,12.12%,12%,136,4898,2.72%,97.28%,4769,10,9,10,5,3,
0500000US31171,"Thomas County, Nebraska",586,318,54.27%,45.73%,68.8,24,4.10%,3,13,10,98,89,90,16,421,106,101,102,100,17.24%,17.41%,17%,29,640,4.95%,95.05%,623,0,3,0,0,0,
0500000US31173,"Thurston County, Nebraska",7218,3712,51.43%,48.57%,41.9,633,8.77%,284,255,61,1244,496,508,231,3503,739,1528,751,569,21.17%,10.40%,8%,260,6513,3.60%,96.40%,2444,24,3897,8,4,16,
0500000US31175,"Valley County, Nebraska",4100,2092,51.02%,48.98%,62.6,99,2.41%,60,140,12,914,320,601,206,2756,807,974,460,613,23.76%,11.22%,15%,116,3943,2.83%,97.17%,3818,15,4,5,5,11,
0500000US31177,"Washington County, Nebraska",20546,10343,50.34%,49.66%,60,780,3.80%,556,683,180,4182,1615,3169,1322,13356,4491,4738,2298,3349,23.06%,11.18%,16%,619,20246,3.01%,96.99%,19359,70,25,100,1,42,
0500000US31179,"Wayne County, Nebraska",9388,4675,49.80%,50.20%,50.8,441,4.70%,476,1543,88,1597,832,1173,551,5189,1724,2073,2375,1261,22.08%,25.30%,13%,991,8706,10.56%,89.44%,7828,350,28,122,8,61,
0500000US31181,"Webster County, Nebraska",3497,1749,50.01%,49.99%,61.9,92,2.63%,112,75,30,805,373,338,216,2350,554,917,448,368,26.22%,12.81%,11%,148,3247,4.23%,95.77%,3111,14,14,9,0,2,
0500000US31183,"Wheeler County, Nebraska",689,339,49.20%,50.80%,65.4,34,4.93%,3,4,0,156,92,95,52,560,147,159,96,95,23.08%,13.93%,14%,20,754,2.90%,97.10%,736,0,2,0,0,1,
0500000US31185,"York County, Nebraska",13671,7095,51.90%,48.10%,61.2,492,3.60%,366,481,260,2471,1460,1624,909,8716,2533,2837,1941,1884,20.75%,14.20%,14%,839,13286,6.14%,93.86%,12559,167,71,90,2,30,
0500000US32001,"Churchill County, Nevada",24606,11967,48.63%,51.37%,52.8,1496,6.08%,742,838,122,4904,1909,2287,867,15646,3154,5646,2747,2409,22.95%,11.16%,10%,3586,21930,14.57%,85.43%,17870,428,1006,640,87,143,
0500000US32003,"Clark County, Nevada",2228866,1117189,50.12%,49.88%,44.1,136653,6.13%,78328,67808,10871,432400,124001,254714,129808,1318088,384522,510728,191809,265585,22.91%,8.61%,12%,701416,1564045,31.47%,68.53%,892802,275002,8487,231972,18877,12890,
0500000US32005,"Douglas County, Nevada",48486,24026,49.55%,50.45%,59.5,1524,3.14%,998,1324,174,8907,4491,7588,4412,35476,12000,9905,5815,7762,20.43%,11.99%,16%,6141,43347,12.67%,87.33%,38856,183,807,898,81,240,
0500000US32007,"Elko County, Nevada",52537,25101,47.78%,52.22%,52.8,2366,4.50%,1736,1909,204,11199,3118,3780,1931,29421,5711,12935,5027,3984,24.62%,9.57%,8%,13592,40110,25.87%,74.13%,34177,494,2378,555,85,247,
0500000US32009,"Esmeralda County, Nevada",1030,554,53.79%,46.21%,42.5,21,2.04%,1,6,0,239,68,113,36,707,149,240,74,113,23.30%,7.18%,11%,139,590,13.50%,86.50%,521,4,20,4,0,0,
0500000US32011,"Eureka County, Nevada",1839,912,49.59%,50.41%,68.7,262,14.25%,8,46,0,535,84,114,28,1156,142,543,130,114,29.53%,7.07%,6%,178,1677,9.68%,90.32%,1545,2,21,4,3,11,
0500000US32013,"Humboldt County, Nevada",16834,8072,47.95%,52.05%,57.3,639,3.80%,621,374,84,3629,924,1449,657,9389,2106,4250,1298,1533,25.25%,7.71%,9%,4511,12774,26.80%,73.20%,11032,137,571,152,26,199,
0500000US32015,"Lander County, Nevada",5565,2546,45.75%,54.25%,50.3,346,6.22%,90,13,0,1363,585,265,214,3342,479,1453,598,265,26.11%,10.75%,5%,1256,4478,22.57%,77.43%,3975,7,206,27,10,19,
0500000US32017,"Lincoln County, Nevada",5177,2263,43.71%,56.29%,43.4,179,3.46%,333,102,0,1548,250,340,262,3191,602,1881,352,340,36.33%,6.80%,7%,294,4205,5.68%,94.32%,3838,168,26,21,13,9,
0500000US32019,"Lyon County, Nevada",55667,27656,49.68%,50.32%,53,2583,4.64%,1939,1010,0,13264,4295,3909,1677,35008,5586,15203,5305,3909,27.31%,9.53%,7%,10339,48896,18.57%,81.43%,42350,488,1083,924,168,252,
0500000US32021,"Mineral County, Nevada",4487,2368,52.78%,47.23%,41.6,416,9.27%,237,161,0,1225,154,390,85,2914,475,1462,315,390,32.58%,7.02%,9%,508,4046,11.32%,88.68%,2858,161,711,64,8,16,
0500000US32023,"Nye County, Nevada",45514,22218,48.82%,51.18%,50.6,3643,8.00%,1365,625,48,12543,3169,2643,1703,30229,4346,13908,3794,2691,30.56%,8.34%,6%,7927,43664,17.42%,82.58%,37313,1496,620,1028,217,291,
0500000US32027,"Pershing County, Nevada",6591,2368,35.93%,64.07%,45.6,284,4.31%,148,121,7,2113,354,229,301,4245,530,2261,475,236,34.30%,7.21%,4%,1499,5151,22.74%,77.26%,4197,322,198,109,8,21,
0500000US32029,"Storey County, Nevada",4086,1943,47.55%,52.45%,53.4,248,6.07%,146,83,0,721,269,710,306,2877,1016,867,352,710,21.22%,8.61%,17%,340,3764,8.32%,91.68%,3338,24,38,67,8,34,
0500000US32031,"Washoe County, Nevada",464182,230266,49.61%,50.39%,48.6,21367,4.60%,13263,19052,4088,76457,27708,63308,38848,286740,102156,89720,46760,67396,19.33%,10.07%,15%,122204,364288,26.33%,73.67%,287862,11527,5790,28063,3250,2485,
0500000US32033,"White Pine County, Nevada",9570,3838,40.10%,59.90%,50.1,306,3.20%,151,240,0,3064,688,676,244,6324,920,3215,928,676,33.59%,9.70%,7%,1457,7623,15.22%,84.78%,6354,438,358,105,19,22,
0500000US32510,"Carson City, Nevada",55244,26798,48.51%,51.49%,46.1,2270,4.11%,1618,1782,124,10587,4092,5990,3113,35068,9103,12205,5874,6114,22.09%,10.63%,11%,14870,43769,26.92%,73.08%,37064,1079,1072,1358,110,292,
0500000US33001,"Belknap County, New Hampshire",61174,31136,50.90%,49.10%,54.2,2353,3.85%,1485,1602,542,12975,5207,8412,6044,42327,14456,14460,6809,8954,23.64%,11.13%,15%,1261,62444,2.06%,97.94%,58714,324,122,582,11,188,
0500000US33003,"Carroll County, New Hampshire",48461,24160,49.86%,50.15%,57.2,1961,4.05%,1245,1070,290,10291,4216,8263,5795,35963,14058,11536,5286,8553,23.80%,10.91%,18%,769,49338,1.59%,98.41%,46947,131,100,358,6,206,
0500000US33005,"Cheshire County, New Hampshire",76040,38811,51.04%,48.96%,48,2467,3.24%,2124,5561,785,16725,5451,11344,6700,50026,18044,18849,11012,12129,24.79%,14.48%,16%,1802,74656,2.37%,97.63%,69264,648,146,1067,46,305,
0500000US33007,"Coos County, New Hampshire",31486,14797,47.00%,53.01%,50,1539,4.89%,776,671,266,9482,2643,3047,1728,21371,4775,10258,3314,3313,32.58%,10.53%,11%,672,30596,2.13%,97.87%,28629,494,84,193,3,71,
0500000US33009,"Grafton County, New Hampshire",90331,45947,50.87%,49.14%,46.5,4107,4.55%,3505,6433,1334,16191,5390,13651,13254,59148,26905,19696,11823,14985,21.80%,13.09%,17%,2579,88539,2.86%,97.14%,80370,783,180,2855,24,368,
0500000US33011,"Hillsborough County, New Hampshire",415305,208765,50.27%,49.73%,50.6,12908,3.11%,12967,12954,5755,75661,30016,72309,41417,272021,113726,88628,42970,78064,21.34%,10.35%,19%,33498,389439,8.07%,91.93%,342652,10044,630,16413,112,2383,
0500000US33013,"Merrimack County, New Hampshire",150902,76712,50.84%,49.16%,53.9,5255,3.48%,4366,6562,1496,30719,12355,21924,16709,100545,38633,35085,18917,23420,23.25%,12.54%,16%,3880,149928,2.57%,97.43%,137252,2536,310,3013,59,575,
0500000US33015,"Rockingham County, New Hampshire",308211,155332,50.40%,49.60%,55.8,6928,2.25%,8298,8165,4391,57481,23174,59273,35039,214811,94312,65779,31339,63664,21.34%,10.17%,21%,10257,303919,3.33%,96.67%,283099,2076,342,6247,79,1236,
0500000US33017,"Strafford County, New Hampshire",130161,66080,50.77%,49.23%,47.5,5771,4.43%,5195,11486,2740,23645,9911,19536,10690,80124,30226,28840,21397,22276,22.16%,16.44%,17%,3914,126975,3.01%,96.99%,114599,1434,251,4473,42,403,
0500000US33019,"Sullivan County, New Hampshire",43173,21702,50.27%,49.73%,49,2531,5.86%,1303,1044,266,11783,3005,6055,3495,29371,9550,13086,4049,6321,30.31%,9.38%,15%,822,42241,1.90%,98.10%,39123,185,134,403,6,181,
0500000US34001,"Atlantic County, New Jersey",264650,136496,51.58%,48.42%,45.6,14271,5.39%,7794,11027,2759,59531,13262,34403,18695,162074,53098,67325,24289,37162,25.44%,9.18%,14%,53713,220821,20.30%,79.70%,148858,39022,357,21563,82,1343,
0500000US34003,"Bergen County, New Jersey",931275,479116,51.45%,48.55%,54.8,27273,2.93%,18489,31703,18351,144267,39857,203933,129576,610882,333509,162756,71560,222284,17.48%,7.68%,24%,204683,751049,21.98%,78.02%,511919,49909,811,157500,130,6464,
0500000US34005,"Burlington County, New Jersey",446301,226637,50.78%,49.22%,51.6,12286,2.75%,12292,15141,5580,88200,26320,78710,42849,296292,121559,100492,41461,84290,22.52%,9.29%,19%,40387,421473,9.05%,90.95%,294510,74807,609,25980,265,3235,
0500000US34007,"Camden County, New Jersey",506721,262211,51.75%,48.25%,44.5,26808,5.29%,13628,16286,6676,103229,26042,69890,42848,310472,112738,116857,42328,76566,23.06%,8.35%,15%,95255,428230,18.80%,81.20%,279274,95135,692,32328,99,2576,
0500000US34009,"Cape May County, New Jersey",92701,47374,51.10%,48.90%,57.2,3454,3.73%,2385,2548,832,22409,5605,15077,8367,65259,23444,24794,8153,15909,26.75%,8.79%,17%,7465,87798,8.05%,91.95%,80040,3305,99,893,22,319,
0500000US34011,"Cumberland County, New Jersey",150085,73556,49.01%,50.99%,40.5,8692,5.79%,5025,3930,1107,39546,7036,11307,5592,81851,16899,44571,10966,12414,29.70%,7.31%,8%,53054,101098,35.35%,64.65%,65808,26375,905,2051,12,595,
0500000US34013,"Essex County, New Jersey",798698,414404,51.89%,48.12%,41,55830,6.99%,22172,29848,9944,150173,32767,114298,80812,466454,195110,172345,62615,124242,21.58%,7.84%,16%,210353,653375,26.34%,73.66%,235125,324081,1238,46957,169,12078,
0500000US34015,"Gloucester County, New Jersey",291745,149993,51.41%,48.59%,50.4,9615,3.30%,7800,12148,4063,64570,18692,45734,22654,189120,68388,72370,30840,49797,24.81%,10.57%,17%,22135,280159,7.59%,92.41%,225355,31517,331,9475,74,1103,
0500000US34017,"Hudson County, New Jersey",671923,337702,50.26%,49.74%,43.9,40445,6.02%,13166,22602,12150,117550,22303,127136,84505,412339,211641,130716,44905,139286,19.45%,6.68%,21%,293019,431835,43.61%,56.39%,206530,71385,1069,123424,233,9210,
0500000US34019,"Hunterdon County, New Jersey",125063,62995,50.37%,49.63%,59.4,2246,1.80%,3273,3766,2254,18384,5700,28619,19807,85621,48426,21657,9466,30873,17.32%,7.57%,25%,10929,118018,8.74%,91.26%,104667,3030,92,5677,8,535,
0500000US34021,"Mercer County, New Jersey",368085,188099,51.10%,48.90%,46.1,18491,5.02%,9968,21320,6262,63046,15094,57526,50538,222488,108064,73014,36414,63788,19.84%,9.89%,17%,84177,303163,22.87%,77.13%,168580,72364,427,48330,106,1879,
0500000US34023,"Middlesex County, New Jersey",825015,418053,50.67%,49.33%,53,30782,3.73%,17862,42430,11096,139729,36061,150370,101943,511381,252313,157591,78491,161466,19.10%,9.51%,20%,193687,669475,23.48%,76.52%,333158,78719,1183,227973,192,7053,
0500000US34025,"Monmouth County, New Jersey",620821,318717,51.34%,48.66%,53.6,19351,3.12%,14184,20609,12358,99354,32536,125760,81157,409796,206917,113538,53145,138118,18.29%,8.56%,22%,80730,562885,13.00%,87.00%,460825,39178,482,36008,97,4566,
0500000US34027,"Morris County, New Jersey",492715,250617,50.86%,49.14%,56.3,10486,2.13%,11411,16046,10648,66295,22501,112546,78980,327178,191526,77706,38547,123194,15.77%,7.82%,25%,76661,432624,15.56%,84.44%,341175,15586,373,57700,93,2337,
0500000US34029,"Ocean County, New Jersey",602018,311408,51.73%,48.27%,52.9,22882,3.80%,14056,18503,7152,138103,32689,85386,44036,381490,129422,152159,51192,92538,25.27%,8.50%,15%,66329,570900,11.02%,88.98%,520578,17649,523,11339,111,3899,
0500000US34031,"Passaic County, New Jersey",502763,257425,51.20%,48.80%,45.2,30820,6.13%,17137,19452,6182,112680,17851,66762,31930,282350,98692,129817,37303,72944,25.82%,7.42%,15%,224030,300088,44.56%,55.44%,203542,51859,688,30209,52,3514,
0500000US34033,"Salem County, New Jersey",62754,32064,51.10%,48.91%,47.1,3361,5.36%,1796,1970,833,16967,4471,6396,3156,39460,9552,18763,6441,7229,29.90%,10.26%,12%,6535,58302,10.41%,89.59%,45279,9049,182,649,13,277,
0500000US34035,"Somerset County, New Jersey",330151,168724,51.11%,48.90%,55.4,7215,2.19%,6892,10584,6660,44899,14628,69810,58422,217383,128232,51791,25212,76470,15.69%,7.64%,23%,57379,287982,17.38%,82.62%,177411,30480,306,67098,69,2015,
0500000US34037,"Sussex County, New Jersey",140996,70718,50.16%,49.84%,55.8,4050,2.87%,4206,4181,1799,30877,8427,24641,12581,97019,37222,35083,12608,26440,24.88%,8.94%,19%,14310,129911,10.15%,89.85%,118247,2858,191,2918,11,666,
0500000US34039,"Union County, New Jersey",555208,284047,51.16%,48.84%,47.7,20907,3.77%,14048,20191,7449,106748,20955,84189,55932,329516,140121,120796,41146,91638,21.76%,7.41%,17%,195519,379826,35.22%,64.78%,211245,112261,552,31963,78,6190,
0500000US34041,"Warren County, New Jersey",105730,53939,51.02%,48.98%,52.5,3646,3.45%,3155,3910,1331,23296,6774,17657,8532,70315,26189,26451,10684,18988,25.02%,10.10%,18%,12225,97407,11.56%,88.44%,84255,5573,96,2886,28,500,
0500000US35001,"Bernalillo County, New Mexico",679037,346283,51.00%,49.00%,41.3,50232,7.40%,18478,28242,5860,107730,40784,91786,74016,422915,165802,126208,69026,97646,18.59%,10.17%,14%,329481,346963,48.52%,51.48%,253355,17871,30628,19226,564,3505,
0500000US35003,"Catron County, New Mexico",3547,1728,48.72%,51.28%,54.3,166,4.68%,86,64,0,1200,201,286,190,2649,476,1286,265,286,36.26%,7.47%,8%,602,2977,16.97%,83.03%,2738,35,47,8,0,37,
0500000US35005,"Chaves County, New Mexico",64912,32510,50.08%,49.92%,45.2,4751,7.32%,2916,1996,262,11013,3816,4922,2399,32871,7321,13929,5812,5184,21.46%,8.95%,8%,37097,28060,57.15%,42.85%,24445,947,411,611,29,258,
0500000US35006,"Cibola County, New Mexico",26763,13214,49.37%,50.63%,38.1,2468,9.22%,970,687,33,5526,1913,2005,1149,14839,3154,6496,2600,2038,24.27%,9.71%,8%,8644,18528,32.30%,67.70%,5538,254,11767,201,7,196,
0500000US35007,"Colfax County, New Mexico",12106,5978,49.38%,50.62%,49.6,730,6.03%,382,257,24,2771,876,1189,765,7982,1954,3153,1133,1213,26.04%,9.36%,10%,5878,6509,48.55%,51.45%,5954,25,108,60,11,39,
0500000US35009,"Curry County, New Mexico",49502,23876,48.23%,51.77%,46.6,4464,9.02%,2218,2649,202,7874,2849,4133,2037,24700,6170,10092,5498,4335,20.39%,11.11%,9%,21796,26634,44.03%,55.97%,21052,2513,249,733,35,211,
0500000US35011,"De Baca County, New Mexico",1995,839,42.06%,57.95%,31,46,2.31%,32,59,42,260,49,63,62,772,125,292,108,105,14.64%,5.41%,5%,654,1044,32.78%,67.22%,983,3,4,4,4,0,
0500000US35013,"Do√±a Ana County, New Mexico",217696,110706,50.85%,49.15%,44.2,20965,9.63%,8178,17005,2881,28539,10781,22915,16239,106922,39154,36717,27786,25796,16.87%,12.76%,12%,147672,71889,67.83%,32.17%,59749,3172,1463,2458,115,839,
0500000US35015,"Eddy County, New Mexico",57865,28656,49.52%,50.48%,50.9,3988,6.89%,2239,1057,488,12171,3745,4021,2412,31329,6433,14410,4802,4509,24.90%,8.30%,8%,31307,31007,54.10%,45.90%,27139,791,518,578,43,404,
0500000US35017,"Grant County, New Mexico",27391,13859,50.60%,49.40%,42.2,2794,10.20%,786,958,127,5655,1686,3100,2015,17447,5115,6441,2644,3227,23.52%,9.65%,12%,13466,14719,49.16%,50.84%,13117,249,265,191,18,168,
0500000US35019,"Guadalupe County, New Mexico",4336,1636,37.73%,62.27%,30,209,4.82%,48,48,0,1632,265,152,140,2833,292,1680,313,152,38.75%,7.22%,4%,3436,1016,79.24%,20.76%,769,64,40,49,0,21,
0500000US35021,"Harding County, New Mexico",432,211,48.84%,51.16%,47.8,17,3.94%,9,32,0,69,66,49,31,281,80,78,98,49,18.06%,22.69%,11%,282,375,65.28%,34.72%,352,2,0,0,0,1,
0500000US35023,"Hidalgo County, New Mexico",4234,2149,50.76%,49.24%,54.9,241,5.69%,127,83,17,1010,234,403,198,2491,601,1137,317,420,26.85%,7.49%,10%,2390,1788,56.45%,43.55%,1645,14,14,11,5,28,
0500000US35025,"Lea County, New Mexico",70359,34165,48.56%,51.44%,48.7,4869,6.92%,2352,3020,166,13524,3343,3467,2693,31913,6160,15876,6363,3633,22.56%,9.04%,5%,45193,29262,64.23%,35.77%,23775,2497,477,636,21,294,
0500000US35027,"Lincoln County, New Mexico",19640,10107,51.46%,48.54%,54.5,1093,5.57%,498,600,70,4909,1039,2460,1279,13434,3739,5407,1639,2530,27.53%,8.35%,13%,6496,13773,33.08%,66.92%,12339,68,429,138,8,137,
0500000US35028,"Los Alamos County, New Mexico",18976,9343,49.24%,50.76%,59.8,319,1.68%,434,407,279,1341,903,3394,5704,13205,9098,1775,1310,3673,9.35%,6.90%,19%,3435,15984,18.10%,81.90%,13446,157,116,1223,15,138,
0500000US35029,"Luna County, New Mexico",24022,11923,49.63%,50.37%,43.4,2130,8.87%,1097,593,32,5570,859,1161,858,11027,2019,6667,1452,1193,27.75%,6.04%,5%,16670,8757,69.39%,30.61%,7671,228,143,160,12,50,
0500000US35031,"McKinley County, New Mexico",71956,37205,51.71%,48.30%,33.8,13219,18.37%,2971,2358,119,16131,3295,2696,2425,34721,5121,19102,5653,2815,26.55%,7.86%,4%,8611,64291,11.97%,88.03%,5946,323,55401,935,34,127,
0500000US35033,"Mora County, New Mexico",4500,2464,54.76%,45.24%,31.2,183,4.07%,125,181,0,1396,264,223,405,3269,628,1521,445,223,33.80%,9.89%,5%,3301,888,73.36%,26.64%,764,10,22,14,0,10,
0500000US35035,"Otero County, New Mexico",66804,32324,48.39%,51.61%,46.2,4731,7.08%,2741,2882,363,12435,4438,5576,2789,38478,8365,15176,7320,5939,22.72%,10.96%,9%,26152,41687,39.15%,60.85%,30931,2299,4173,1001,145,377,
0500000US35037,"Quay County, New Mexico",8265,4382,53.02%,46.98%,39.6,570,6.90%,76,236,10,2245,554,577,350,4952,927,2321,790,587,28.08%,9.56%,7%,3848,4898,46.56%,53.44%,4434,89,57,48,2,36,
0500000US35039,"Rio Arriba County, New Mexico",38962,19996,51.32%,48.68%,37.1,4949,12.70%,1377,1125,42,8984,2324,2832,2112,23185,4944,10361,3449,2874,26.59%,8.85%,7%,27159,13204,69.71%,30.29%,5945,160,6135,233,5,184,
0500000US35041,"Roosevelt County, New Mexico",18723,9272,49.52%,50.48%,42.8,2041,10.90%,827,2025,283,3459,544,1603,775,8806,2378,4286,2569,1886,22.89%,13.72%,10%,8397,10794,44.85%,55.15%,9328,443,163,173,18,114,
0500000US35043,"Sandoval County, New Mexico",144954,73705,50.85%,49.15%,51.4,8173,5.64%,3954,4966,548,25314,10467,18181,12808,90904,30989,29268,15433,18729,20.19%,10.65%,13%,57617,91217,39.75%,60.25%,63426,2823,16891,2320,166,679,
0500000US35045,"San Juan County, New Mexico",125608,63472,50.53%,49.47%,46,12348,9.83%,4057,4193,246,23793,10570,7370,5211,70334,12581,27850,14763,7616,22.17%,11.75%,6%,23630,98031,18.81%,81.19%,43583,554,48413,872,67,454,
0500000US35047,"San Miguel County, New Mexico",27546,13864,50.33%,49.67%,35.7,2795,10.15%,833,1590,146,4957,1845,2198,2148,16422,4346,5790,3435,2344,21.02%,12.47%,9%,20490,6711,74.38%,25.62%,5447,264,278,132,2,132,
0500000US35049,"Santa Fe County, New Mexico",150319,77499,51.56%,48.44%,45.3,7512,5.00%,3876,4389,714,25794,8127,23086,22595,100771,45681,29670,12516,23800,19.74%,8.33%,16%,74377,80446,49.48%,50.52%,67861,1221,3869,2238,72,969,
0500000US35051,"Sierra County, New Mexico",10988,5469,49.77%,50.23%,46.2,765,6.96%,221,134,97,2599,929,1169,761,7744,1930,2820,1063,1266,25.66%,9.67%,12%,3311,8265,30.13%,69.87%,7507,70,106,119,3,31,
0500000US35053,"Socorro County, New Mexico",16723,8042,48.09%,51.91%,37.2,1239,7.41%,801,1071,53,4127,526,1109,1279,9003,2388,4928,1597,1162,29.47%,9.55%,7%,8353,8242,49.95%,50.05%,5361,121,1946,295,8,75,
0500000US35055,"Taos County, New Mexico",32759,16633,50.77%,49.23%,40,2491,7.60%,780,1121,50,6206,2193,4656,3330,22536,7986,6986,3314,4706,21.33%,10.12%,14%,17430,17059,53.21%,46.79%,13706,130,1830,196,4,274,
0500000US35057,"Torrance County, New Mexico",15477,7596,49.08%,50.92%,48.5,1287,8.32%,456,612,78,3815,673,1059,600,9099,1659,4271,1285,1137,27.60%,8.30%,7%,6265,8780,40.48%,59.52%,7761,121,237,51,2,90,
0500000US35059,"Union County, New Mexico",4106,1884,45.88%,54.12%,37.2,222,5.41%,73,79,31,1314,159,215,155,2492,370,1387,238,246,33.78%,5.80%,6%,1596,2483,38.87%,61.13%,2234,65,57,6,4,15,
0500000US35061,"Valencia County, New Mexico",76518,38024,49.69%,50.31%,46.5,4909,6.42%,3192,2000,246,16762,4401,5819,4483,43896,10302,19954,6401,6065,26.08%,8.37%,8%,45775,30430,59.82%,40.18%,24651,747,2353,341,32,447,
0500000US36001,"Albany County, New York",306165,158092,51.64%,48.36%,42.2,18502,6.04%,13238,18090,10181,44733,23533,45382,43936,189407,89318,57971,41623,55563,18.93%,13.59%,18%,21595,293253,7.05%,92.95%,210895,40667,494,24363,166,1821,
0500000US36003,"Allegany County, New York",46304,22947,49.56%,50.44%,49.1,3086,6.66%,1688,4727,355,10573,4230,3529,3315,27423,6844,12261,8957,3884,26.48%,19.34%,8%,965,45491,2.08%,97.92%,42327,809,91,373,6,218,
0500000US36005,"Bronx County, New York",1427056,754572,52.88%,47.12%,32.3,168983,11.84%,39341,61573,13904,257988,74162,120154,68779,683029,188933,297329,135735,134058,20.84%,9.51%,9%,806463,666191,56.51%,43.49%,130796,419393,3087,67766,457,16322,
0500000US36007,"Broome County, New York",192042,97523,50.78%,49.22%,44.1,17153,8.93%,7453,13835,4001,39590,16243,19987,16755,115160,36742,47043,30078,23988,24.50%,15.66%,12%,10285,188398,5.36%,94.64%,156173,11547,413,9337,64,864,
0500000US36009,"Cattaraugus County, New York",76750,38477,50.13%,49.87%,49,4982,6.49%,2793,2758,371,20642,7126,5288,5208,47281,10496,23435,9884,5659,30.53%,12.88%,7%,1615,75427,2.10%,97.90%,67554,996,2661,560,9,212,
0500000US36011,"Cayuga County, New York",76958,37483,48.71%,51.29%,45.9,4673,6.07%,2071,2636,419,18394,7851,7539,4681,49067,12220,20465,10487,7958,26.59%,13.63%,10%,2636,73612,3.43%,96.57%,66313,2727,224,379,54,253,
0500000US36013,"Chautauqua County, New York",127584,64623,50.65%,49.35%,46.6,9128,7.15%,3850,6000,816,30901,12196,11609,9008,79938,20617,34751,18196,12425,27.24%,14.26%,10%,11769,115888,9.22%,90.78%,106063,2891,497,796,49,363,
0500000US36015,"Chemung County, New York",84115,42433,50.45%,49.55%,46,4781,5.68%,2463,2708,559,20543,7568,7549,6421,53323,13970,23006,10276,8108,27.35%,12.22%,10%,2938,81210,3.49%,96.51%,69559,5009,198,1426,15,228,
0500000US36017,"Chenango County, New York",47527,23704,49.88%,50.13%,50.2,2580,5.43%,1514,1124,263,13734,3741,3572,2903,30196,6475,15248,4865,3835,32.08%,10.24%,8%,1117,46103,2.35%,97.65%,43153,345,93,236,15,109,
0500000US36019,"Clinton County, New York",80320,39040,48.61%,51.39%,45.8,4199,5.23%,3233,5424,1114,20050,6072,7447,6036,48608,13483,23283,11496,8561,28.99%,14.31%,11%,2856,76987,3.56%,96.44%,69251,2753,238,957,24,270,
0500000US36021,"Columbia County, New York",60016,30063,50.09%,49.91%,50.8,2694,4.49%,1675,1152,679,13377,5787,8035,7355,41557,15390,15052,6939,8714,25.08%,11.56%,15%,3542,58028,5.90%,94.10%,50795,2421,70,1423,16,348,
0500000US36023,"Cortland County, New York",47618,24203,50.83%,49.17%,43.2,2496,5.24%,2192,5284,715,9339,3991,4411,3648,27165,8059,11531,9275,5126,24.22%,19.48%,11%,1658,45151,3.48%,96.52%,40801,829,113,1018,6,204,
0500000US36025,"Delaware County, New York",44676,22123,49.52%,50.48%,48.4,3196,7.15%,2075,1840,196,12881,3782,3890,3371,29376,7261,14956,5622,4086,33.48%,12.58%,9%,1985,42323,4.44%,95.56%,38821,1003,93,480,7,154,
0500000US36027,"Dutchess County, New York",293524,147681,50.31%,49.69%,48.2,11563,3.94%,8739,15118,4058,54492,21686,40068,35148,188307,75216,63231,36804,44126,21.54%,12.54%,15%,42224,253687,14.39%,85.61%,198495,30126,387,10635,67,1956,
0500000US36029,"Erie County, New York",918873,474133,51.60%,48.40%,44.2,58040,6.32%,24473,39252,13279,173898,77607,127836,99701,596453,227537,198371,116859,141115,21.59%,12.72%,15%,59658,894578,6.49%,93.51%,678236,129874,4667,46090,199,3254,
0500000US36031,"Essex County, New York",37281,17847,47.87%,52.13%,49.4,1659,4.45%,845,976,231,9160,3285,4759,3815,26005,8574,10005,4261,4990,26.84%,11.43%,13%,978,36403,2.62%,97.38%,33714,610,74,229,7,133,
0500000US36033,"Franklin County, New York",50389,22718,45.09%,54.92%,45.8,3945,7.83%,1888,2013,282,13326,4603,3770,3596,31195,7366,15214,6616,4052,30.19%,13.13%,8%,1387,46168,2.75%,97.25%,38559,1686,4102,191,0,91,
0500000US36035,"Fulton County, New York",53452,26790,50.12%,49.88%,46.4,3633,6.80%,1554,1523,293,13999,5933,3788,3243,34133,7031,15553,7456,4081,29.10%,13.95%,8%,2134,51190,3.99%,96.01%,47051,966,89,343,0,164,
0500000US36037,"Genesee County, New York",57554,28744,49.94%,50.06%,49.9,2611,4.54%,1656,2206,328,15587,5717,5344,3705,38148,9049,17243,7923,5672,29.96%,13.77%,10%,2752,55636,4.78%,95.22%,50960,1358,361,412,16,173,
0500000US36039,"Greene County, New York",47335,22656,47.86%,52.14%,46.1,2094,4.42%,1710,1212,279,13413,4171,4416,4089,31005,8505,15123,5383,4695,31.95%,11.37%,10%,3109,44822,6.57%,93.43%,39494,2159,100,500,3,238,
0500000US36041,"Hamilton County, New York",4454,2188,49.12%,50.88%,47.4,200,4.49%,123,182,14,982,484,348,344,2772,692,1105,666,362,24.81%,14.95%,8%,100,5007,2.25%,97.75%,4769,30,14,12,1,5,
0500000US36043,"Herkimer County, New York",61738,31182,50.51%,49.49%,49.3,3298,5.34%,1716,2308,609,16076,5937,5291,3947,39642,9238,17792,8245,5900,28.82%,13.35%,10%,1530,58609,2.48%,97.52%,54653,682,76,359,32,153,
0500000US36045,"Jefferson County, New York",111454,53059,47.61%,52.39%,52.3,7903,7.09%,6641,5216,938,24464,8779,9455,6477,64484,15932,31105,13995,10393,27.91%,12.56%,9%,7990,108731,7.17%,92.83%,92755,6271,461,2185,300,501,
0500000US36047,"Kings County, New York",2576771,1355733,52.61%,47.39%,41.2,210311,8.16%,56216,83813,41188,449299,109644,414484,277022,1481319,691506,505515,193457,455672,19.62%,7.51%,18%,516426,2219648,20.04%,79.96%,968427,729696,3964,370776,718,32897,
0500000US36049,"Lewis County, New York",26456,13213,49.94%,50.06%,55.3,1147,4.34%,779,759,203,8174,2410,1925,1445,16777,3370,8953,3169,2128,33.84%,11.98%,8%,460,26122,1.74%,98.26%,24942,103,40,65,11,52,
0500000US36051,"Livingston County, New York",63218,31431,49.72%,50.28%,47.5,3884,6.14%,2557,5748,701,13769,5427,6297,5421,39051,11718,16326,11175,6998,25.82%,17.68%,11%,2721,59113,4.30%,95.70%,54611,1071,125,653,6,203,
0500000US36053,"Madison County, New York",70990,35981,50.69%,49.32%,46.9,2492,3.51%,3047,5188,650,16676,7076,7122,5679,44516,12801,19723,12264,7772,27.78%,17.28%,11%,1673,66343,2.36%,97.64%,60965,1071,435,664,11,187,
0500000US36055,"Monroe County, New York",743084,384667,51.77%,48.23%,44.2,46358,6.24%,20235,34818,11755,118724,59950,110833,91057,467677,201890,138959,94768,122588,18.70%,12.75%,16%,72745,686698,9.79%,90.21%,506153,112710,1320,32294,181,2958,
0500000US36057,"Montgomery County, New York",49294,25053,50.82%,49.18%,45.2,4064,8.24%,1207,1293,389,11998,4428,3639,2740,30031,6379,13205,5721,4028,26.79%,11.61%,8%,7312,42220,14.83%,85.17%,38237,987,83,479,9,210,
0500000US36059,"Nassau County, New York",1355683,695183,51.28%,48.72%,54,34876,2.57%,28704,52407,28471,208048,75783,242062,199687,865245,441749,236752,128190,270533,17.46%,9.46%,20%,256425,1139349,18.91%,81.09%,779454,147216,1714,163165,292,11780,
0500000US36061,"New York County, New York",1629153,857536,52.64%,47.36%,35.3,116693,7.16%,27293,57718,49428,152846,46744,396161,381322,1098289,777483,180139,104462,445589,11.06%,6.41%,27%,402640,1291611,24.71%,75.29%,793294,199592,1895,219624,882,13335,
0500000US36063,"Niagara County, New York",210145,107758,51.28%,48.72%,48.1,12154,5.78%,5901,6984,2545,48828,21622,22251,16401,138193,38652,54729,28606,24796,26.04%,13.61%,12%,7818,204848,3.72%,96.28%,173691,16206,2294,2439,45,737,
0500000US36065,"Oneida County, New York",229074,114855,50.14%,49.86%,46.7,14812,6.47%,6206,10320,2645,48928,20083,24039,18250,141329,42289,55134,30403,26684,24.07%,13.27%,12%,15191,216934,6.63%,93.37%,180984,14989,508,10522,72,729,
0500000US36067,"Onondaga County, New York",461591,238922,51.76%,48.24%,45.1,30261,6.56%,11028,24649,7477,80358,38766,63623,50687,288576,114310,91386,63415,71100,19.80%,13.74%,15%,26572,449944,5.76%,94.24%,347290,54410,2940,20119,106,1955,
0500000US36069,"Ontario County, New York",109774,55977,50.99%,49.01%,49.2,4179,3.81%,3562,4341,1281,20342,10772,15260,12595,72483,27855,23904,15113,16541,21.78%,13.77%,15%,6113,106345,5.57%,94.43%,97397,2439,197,1374,23,418,
0500000US36071,"Orange County, New York",382077,190721,49.92%,50.08%,50.2,18622,4.87%,12701,17174,5102,69904,26139,43331,31966,219792,75297,82605,43313,48433,21.62%,11.34%,13%,89744,311566,23.49%,76.51%,231848,41341,754,11665,104,12012,
0500000US36073,"Orleans County, New York",40624,20424,50.28%,49.72%,50.4,2507,6.17%,1204,1264,98,12004,3315,3145,1687,25969,4832,13208,4579,3243,32.51%,11.27%,8%,2087,38256,5.14%,94.86%,34037,1840,177,154,12,141,
0500000US36075,"Oswego County, New York",117630,58718,49.92%,50.08%,46.1,9612,8.17%,3431,7030,1196,30021,10441,8996,7086,71362,16082,33452,17471,10192,28.44%,14.85%,9%,3616,113909,3.07%,96.93%,105710,1370,457,870,19,302,
0500000US36077,"Otsego County, New York",59593,30774,51.64%,48.36%,46.2,3367,5.65%,3522,4918,644,12289,4814,7231,6132,37099,13363,15811,9732,7875,26.53%,16.33%,13%,2392,56132,4.01%,95.99%,51490,1189,109,813,7,180,
0500000US36079,"Putnam County, New York",98714,49512,50.16%,49.84%,57.1,2864,2.90%,2147,3293,1902,18672,6350,16351,12602,65838,28953,20819,9643,18253,21.09%,9.77%,18%,17760,79908,17.99%,82.01%,71942,2425,80,2146,12,561,
0500000US36081,"Queens County, New York",2270976,1168791,51.47%,48.53%,46.8,108393,4.77%,43365,81743,29787,440783,127459,340259,208784,1354905,549043,484148,209202,370046,21.32%,9.21%,16%,667861,1737603,29.41%,70.59%,549358,381375,9576,656583,1110,55489,
0500000US36083,"Rensselaer County, New York",159013,80526,50.64%,49.36%,44.6,7247,4.56%,5385,6702,2531,30747,15323,22396,15573,103570,37969,36132,22025,24927,22.72%,13.85%,16%,9482,151648,5.96%,94.04%,124600,11800,310,5711,17,706,
0500000US36085,"Richmond County, New York",475596,244961,51.51%,48.49%,51.4,25847,5.43%,10703,16348,8090,98711,24252,69718,45528,293812,115246,109414,40600,77808,23.01%,8.54%,16%,96960,398787,20.39%,79.61%,277981,46835,624,58753,135,3141,
0500000US36087,"Rockland County, New York",325213,165621,50.93%,49.07%,53.4,21334,6.56%,8417,12021,4919,44649,15727,46584,38666,180205,85250,53066,27748,51503,16.32%,8.53%,16%,66451,271878,20.43%,79.57%,206113,33775,390,20413,42,3445,
0500000US36089,"St. Lawrence County, New York",108352,53158,49.06%,50.94%,45.3,8344,7.70%,3909,9185,562,25840,8548,8345,8545,63502,16890,29749,17733,8907,27.46%,16.37%,8%,2832,105673,2.61%,97.39%,96556,2788,1143,1089,19,298,
0500000US36091,"Saratoga County, New York",229313,116036,50.60%,49.40%,54.4,5760,2.51%,4573,8422,3977,40019,19102,38268,30972,154491,69240,44592,27524,42245,19.45%,12.00%,18%,8667,226842,3.78%,96.22%,203781,3752,301,7444,60,833,
0500000US36093,"Schenectady County, New York",155086,79642,51.35%,48.65%,41.7,7218,4.65%,4532,6060,1732,30589,14119,19377,15124,97779,34501,35121,20179,21109,22.65%,13.01%,14%,12505,145556,8.06%,91.94%,104878,15943,930,8281,130,4469,
0500000US36095,"Schoharie County, New York",31189,15729,50.43%,49.57%,48.1,1572,5.04%,900,1749,321,8110,2696,2998,2281,20296,5279,9010,4445,3319,28.89%,14.25%,11%,1075,28639,3.45%,96.55%,26658,277,68,210,3,123,
0500000US36097,"Schuyler County, New York",17845,8886,49.80%,50.21%,50.4,943,5.28%,596,445,66,4579,1497,1684,1378,12037,3062,5175,1942,1750,29.00%,10.88%,10%,329,17569,1.84%,98.16%,16618,91,38,108,1,43,
0500000US36099,"Seneca County, New York",34295,16364,47.72%,52.29%,47.6,1663,4.85%,720,1011,338,8473,3205,2960,2307,20958,5267,9193,4216,3298,26.81%,12.29%,10%,1367,32447,3.99%,96.01%,29273,1263,151,268,3,80,
0500000US36101,"Steuben County, New York",95843,48035,50.12%,49.88%,51.5,5289,5.52%,2886,2254,817,24086,9856,8500,8233,61963,16733,26972,12110,9317,28.14%,12.64%,10%,1718,91866,1.79%,98.21%,84338,1416,203,1616,12,301,
0500000US36103,"Suffolk County, New York",1481364,752522,50.80%,49.20%,51.2,47288,3.19%,37410,59923,24660,272457,100078,210675,175241,934154,385916,309867,160001,235335,20.92%,10.80%,16%,332959,1192961,22.48%,77.52%,967330,107268,3102,65019,241,9479,
0500000US36105,"Sullivan County, New York",75329,36734,48.77%,51.24%,45.7,3810,5.06%,1901,2670,493,17230,5563,7808,6350,46363,14158,19131,8233,8301,25.40%,10.93%,11%,14007,64617,18.59%,81.41%,52691,6069,174,1569,10,602,
0500000US36107,"Tioga County, New York",48431,24387,50.35%,49.65%,56.8,1988,4.10%,1211,1406,463,12466,4427,5476,3583,31873,9059,13677,5833,5939,28.24%,12.04%,12%,1117,47338,2.31%,97.69%,44195,434,62,370,12,158,
0500000US36109,"Tompkins County, New York",102237,51704,50.57%,49.43%,39.2,10361,10.13%,3495,17940,5308,11102,5706,14069,17779,56693,31848,14597,23646,19377,14.28%,23.13%,19%,7077,98663,6.92%,93.08%,76737,4274,248,10487,35,622,
0500000US36111,"Ulster County, New York",178371,89871,50.38%,49.62%,45.4,12012,6.73%,4398,8522,1984,37604,13948,23177,20090,118973,43267,42002,22470,25161,23.55%,12.60%,14%,21119,160732,11.84%,88.16%,136695,10152,306,3778,45,1218,
0500000US36113,"Warren County, New York",64187,32588,50.77%,49.23%,50.8,2216,3.45%,1107,2125,662,14178,5499,8262,7234,44244,15496,15285,7624,8924,23.81%,11.88%,14%,1752,63985,2.73%,97.27%,59299,736,139,729,0,189,
0500000US36115,"Washington County, New York",61304,29647,48.36%,51.64%,44.9,2382,3.89%,1959,1392,633,17699,4859,5182,3849,39433,9031,19658,6251,5815,32.07%,10.20%,9%,1761,59541,2.87%,97.13%,54605,1563,149,319,22,143,
0500000US36117,"Wayne County, New York",90103,45449,50.44%,49.56%,53.3,4248,4.71%,2981,2551,512,20971,8841,8810,6356,57468,15166,23952,11392,9322,26.58%,12.64%,10%,4514,86769,5.01%,94.99%,79230,2397,171,473,13,272,
0500000US36119,"Westchester County, New York",968738,499651,51.58%,48.42%,50.3,38520,3.98%,21955,34981,18718,127493,43847,164540,168990,594341,333530,149448,78828,183258,15.43%,8.14%,19%,269334,735123,27.80%,72.20%,497684,131010,1017,64907,150,8651,
0500000US36121,"Wyoming County, New York",40027,18572,46.40%,53.60%,51.7,1449,3.62%,968,1389,310,11795,4121,3269,2023,26598,5292,12763,5510,3579,31.89%,13.77%,9%,1490,39041,3.72%,96.28%,35579,1852,83,217,6,77,
0500000US36123,"Yates County, New York",24981,13052,52.25%,47.75%,50.8,1377,5.51%,692,1030,226,5786,1776,2356,1716,14389,4072,6478,2806,2582,25.93%,11.23%,10%,674,24100,2.70%,97.30%,23049,145,28,93,8,77,
0500000US37001,"Alamance County, North Carolina",166144,87290,52.54%,47.46%,47,11035,6.64%,4183,9888,1082,31196,12234,19504,8797,97721,28301,35379,22122,20586,21.29%,13.31%,12%,24703,146712,14.87%,85.13%,102487,33555,584,2811,86,762,
0500000US37003,"Alexander County, North Carolina",37271,18222,48.89%,51.11%,53.2,1854,4.97%,1090,1076,234,10740,2962,2683,1143,22429,3826,11830,4038,2917,31.74%,10.83%,8%,1836,34608,4.93%,95.07%,30893,1919,111,390,1,83,
0500000US37005,"Alleghany County, North Carolina",11085,5708,51.49%,48.51%,58.8,759,6.85%,149,350,119,2367,715,1069,699,6706,1768,2516,1065,1188,22.70%,9.61%,11%,1288,9600,11.62%,88.38%,9186,103,35,15,6,4,
0500000US37007,"Anson County, North Carolina",24430,12036,49.27%,50.73%,39.1,1545,6.32%,933,714,137,6979,1591,1391,561,14295,1952,7912,2305,1528,32.39%,9.44%,6%,665,21390,2.72%,97.28%,10593,9838,89,221,4,38,
0500000US37009,"Ashe County, North Carolina",27009,13721,50.80%,49.20%,58.2,1706,6.32%,824,486,161,6424,2440,2785,1339,17770,4124,7248,2926,2946,26.84%,10.83%,11%,1519,25058,5.62%,94.38%,24028,125,48,102,12,43,
0500000US37011,"Avery County, North Carolina",17510,7875,44.97%,55.03%,49.7,767,4.38%,591,809,67,4157,1066,1963,1208,11493,3171,4748,1875,2030,27.12%,10.71%,12%,987,16819,5.64%,94.36%,15549,649,58,56,1,44,
0500000US37013,"Beaufort County, North Carolina",47160,24730,52.44%,47.56%,52.1,2686,5.70%,1455,1260,160,10989,3821,4301,2812,30344,7113,12444,5081,4461,26.39%,10.77%,9%,3433,41219,7.28%,92.72%,29431,10195,90,164,16,122,
0500000US37015,"Bertie County, North Carolina",19081,9509,49.84%,50.17%,39.7,1716,8.99%,686,516,20,5243,990,1256,818,11266,2074,5929,1506,1276,31.07%,7.89%,7%,330,17604,1.73%,98.27%,6298,10674,57,63,0,49,
0500000US37017,"Bladen County, North Carolina",33209,17227,51.87%,48.13%,43.8,3556,10.71%,884,1023,56,7386,2392,3070,1274,19891,4344,8270,3415,3126,24.90%,10.28%,9%,2546,27060,7.67%,92.33%,15830,9505,701,47,8,67,
0500000US37019,"Brunswick County, North Carolina",137303,71401,52.00%,48.00%,60.8,7632,5.56%,2971,2904,351,31683,12624,20654,11479,100301,32133,34654,15528,21005,25.24%,11.31%,15%,7420,129273,5.40%,94.60%,110716,11392,743,890,75,366,
0500000US37021,"Buncombe County, North Carolina",259576,135181,52.08%,47.92%,47.1,9774,3.77%,7528,8069,1927,44368,17467,48024,31298,175720,79322,51896,25536,49951,19.99%,9.84%,19%,21922,247530,8.45%,91.55%,214862,15017,727,3274,467,1382,
0500000US37023,"Burke County, North Carolina",90148,45213,50.15%,49.85%,49.6,5601,6.21%,2758,2611,449,20944,8622,7076,3961,54360,11037,23702,11233,7525,26.29%,12.46%,8%,7184,80386,7.97%,92.03%,68664,4762,238,3150,64,240,
0500000US37025,"Cabarrus County, North Carolina",211605,108469,51.26%,48.74%,52.4,8268,3.91%,6311,5983,1870,35721,13579,29881,17242,127349,47123,42032,19562,31751,19.86%,9.24%,15%,27263,198541,12.88%,87.12%,133781,41687,598,11933,122,1108,
0500000US37027,"Caldwell County, North Carolina",82056,41562,50.65%,49.35%,50.6,4380,5.34%,2165,2617,478,19653,6324,6480,2889,48171,9369,21818,8941,6958,26.59%,10.90%,8%,4923,75729,6.00%,94.00%,67868,3843,196,527,15,238,
0500000US37029,"Camden County, North Carolina",10654,5285,49.61%,50.39%,60.9,182,1.71%,225,202,35,2467,1030,1035,489,6693,1524,2692,1232,1070,25.27%,11.56%,10%,340,10015,3.19%,96.81%,8200,1049,40,118,1,53,
0500000US37031,"Carteret County, North Carolina",69301,35373,51.04%,48.96%,55,2827,4.08%,1613,1778,302,13361,6108,8961,6075,48541,15036,14974,7886,9263,21.61%,11.38%,13%,3119,64567,4.50%,95.50%,57538,3208,252,584,63,252,
0500000US37033,"Caswell County, North Carolina",22619,11203,49.53%,50.47%,51.6,1346,5.95%,692,588,235,5569,2025,1719,890,13553,2609,6261,2613,1954,27.68%,11.55%,9%,1002,21734,4.43%,95.57%,14036,6804,65,61,13,57,
0500000US37035,"Catawba County, North Carolina",158507,80994,51.10%,48.90%,50.7,8563,5.40%,4598,5816,1353,33264,13563,17844,7543,95173,25387,37862,19379,19197,23.89%,12.23%,12%,17377,143233,10.96%,89.04%,116120,12628,379,6937,78,539,
0500000US37037,"Chatham County, North Carolina",72853,38162,52.38%,47.62%,57.4,2978,4.09%,1893,1446,477,10623,4668,12694,10822,47967,23516,12516,6114,13171,17.18%,8.39%,18%,10372,65913,14.24%,85.76%,53087,7768,173,1616,24,308,
0500000US37039,"Cherokee County, North Carolina",28413,14500,51.03%,48.97%,57.5,2342,8.24%,880,547,131,7347,2746,2905,1900,19524,4805,8227,3293,3036,28.96%,11.59%,11%,899,27875,3.16%,96.84%,25366,373,417,158,0,66,
0500000US37041,"Chowan County, North Carolina",13995,7364,52.62%,47.38%,52,1294,9.25%,176,177,44,3467,1099,1439,868,8918,2307,3643,1276,1483,26.03%,9.12%,11%,530,13178,3.79%,96.21%,8268,4376,43,39,1,18,
0500000US37043,"Clay County, North Carolina",11150,5992,53.74%,46.26%,59.3,506,4.54%,192,215,0,2410,980,1524,823,7646,2347,2602,1195,1524,23.34%,10.72%,14%,438,10651,3.93%,96.07%,10044,60,44,40,7,23,
0500000US37045,"Cleveland County, North Carolina",97765,50615,51.77%,48.23%,45.8,8995,9.20%,2780,4366,601,23078,7314,8271,4864,57792,13135,25858,11680,8872,26.45%,11.95%,9%,4039,95480,4.13%,95.87%,70163,20034,222,854,23,327,
0500000US37047,"Columbus County, North Carolina",55659,28079,50.45%,49.55%,42.6,5203,9.35%,1949,1553,234,14794,4069,3415,1653,33015,5068,16743,5622,3649,30.08%,10.10%,7%,2613,48010,4.69%,95.31%,30019,14503,1670,156,10,143,
0500000US37049,"Craven County, North Carolina",102290,50877,49.74%,50.26%,52.3,4830,4.72%,5762,5047,611,17478,8274,10473,6426,60219,16899,23240,13321,11084,22.72%,13.02%,11%,7195,93525,7.03%,92.97%,64933,19903,318,3059,150,446,
0500000US37051,"Cumberland County, North Carolina",334562,168460,50.35%,49.65%,44.2,26398,7.89%,16555,20587,2707,54809,22451,34673,18510,190091,53183,71364,43038,37380,21.33%,12.86%,11%,39498,295230,11.81%,88.19%,133201,124173,4647,8943,1357,2206,
0500000US37053,"Currituck County, North Carolina",27210,13695,50.33%,49.67%,59.2,1024,3.76%,768,552,163,6095,1851,3540,1373,17690,4913,6863,2403,3703,25.22%,8.83%,14%,1218,26882,4.48%,95.52%,23505,1377,98,265,22,109,
0500000US37055,"Dare County, North Carolina",36698,18321,49.92%,50.08%,53.2,1670,4.55%,886,744,343,6035,2596,7062,3496,26003,10558,6921,3340,7405,18.86%,9.10%,20%,2554,34361,6.96%,93.04%,31921,678,99,260,10,140,
0500000US37057,"Davidson County, North Carolina",166837,85392,51.18%,48.82%,54.1,9830,5.89%,4579,4676,1366,37647,12679,15627,6599,99790,22226,42226,17355,16993,25.31%,10.40%,10%,13902,155028,8.33%,91.67%,129487,15839,665,2440,43,491,
0500000US37059,"Davie County, North Carolina",42543,21915,51.51%,48.49%,54.2,2105,4.95%,1504,990,172,9805,3057,4906,2491,27343,7397,11309,4047,5078,26.58%,9.51%,12%,3375,39337,7.93%,92.07%,34809,2413,96,277,5,124,
0500000US37061,"Duplin County, North Carolina",58965,30219,51.25%,48.75%,47.8,4676,7.93%,1148,2386,218,12628,3692,4087,1751,31536,5838,13776,6078,4305,23.36%,10.31%,7%,10813,37902,18.34%,81.66%,24945,11437,154,155,4,120,
0500000US37063,"Durham County, North Carolina",317665,165858,52.21%,47.79%,42.4,20331,6.40%,7163,14344,6847,38845,15533,56443,52010,196496,108453,46008,29877,63290,14.48%,9.41%,20%,50104,274729,15.77%,84.23%,133768,109225,704,16707,83,1809,
0500000US37065,"Edgecombe County, North Carolina",52069,27901,53.59%,46.42%,41.8,5999,11.52%,1804,1183,196,13748,3180,4214,1665,30121,5879,15552,4363,4410,29.87%,8.38%,8%,2706,46194,5.20%,94.80%,17340,27299,128,112,9,138,
0500000US37067,"Forsyth County, North Carolina",378499,198966,52.57%,47.43%,46,27212,7.19%,11971,15795,4293,63898,22004,53484,32857,226593,86341,75869,37799,57777,20.04%,9.99%,15%,54688,327902,14.45%,85.55%,208126,93738,978,9179,233,1623,
0500000US37069,"Franklin County, North Carolina",68027,34261,50.36%,49.64%,52.4,3693,5.43%,1642,2610,358,14137,5148,7271,2775,41096,10046,15779,7758,7629,23.20%,11.40%,11%,6962,61611,10.23%,89.77%,42285,15785,259,452,17,277,
0500000US37071,"Gaston County, North Carolina",222119,114988,51.77%,48.23%,48.1,12996,5.85%,6843,6979,1253,46846,16519,23333,10648,131858,33981,53689,23498,24586,24.17%,10.58%,11%,20068,207875,9.03%,90.97%,153653,39762,753,3509,59,844,
0500000US37073,"Gates County, North Carolina",11519,5948,51.64%,48.36%,50.5,512,4.44%,358,278,64,3287,1072,640,405,7460,1045,3645,1350,704,31.64%,11.72%,6%,201,10277,1.74%,98.26%,6705,3022,64,21,10,29,
0500000US37075,"Graham County, North Carolina",8501,4498,52.91%,47.09%,56.3,600,7.06%,194,331,0,2114,606,549,270,5054,819,2308,937,549,27.15%,11.02%,6%,219,7811,2.58%,97.42%,6885,46,570,20,4,4,
0500000US37077,"Granville County, North Carolina",59823,29358,49.08%,50.93%,49.3,3359,5.61%,1602,1757,293,13086,4288,6801,3302,36532,10103,14688,6045,7094,24.55%,10.10%,12%,6211,54781,10.38%,89.62%,33610,18315,205,366,24,207,
0500000US37079,"Greene County, North Carolina",20987,9458,45.07%,54.93%,40.1,1379,6.57%,751,534,33,4797,1884,1152,409,11479,1561,5548,2418,1185,26.44%,11.52%,6%,2936,17515,13.99%,86.01%,9644,7206,95,37,0,78,
0500000US37081,"Guilford County, North Carolina",532956,280499,52.63%,47.37%,43.2,32886,6.17%,14355,32149,5684,83781,31947,83397,46969,319109,130366,98136,64096,89081,18.41%,12.03%,17%,52152,489147,9.79%,90.21%,255640,179423,1918,28719,216,2850,
0500000US37083,"Halifax County, North Carolina",50678,26233,51.76%,48.24%,42.5,5379,10.61%,1938,1152,110,13484,2932,3567,1724,28530,5291,15422,4084,3677,30.43%,8.06%,7%,1454,47168,2.87%,97.13%,19070,24737,1593,281,11,142,
0500000US37085,"Harnett County, North Carolina",134328,67757,50.44%,49.56%,49.3,10129,7.54%,3666,5568,928,25305,10429,13043,6299,77145,19342,28971,15997,13971,21.57%,11.91%,10%,18899,114669,14.07%,85.93%,77876,26769,978,1408,242,707,
0500000US37087,"Haywood County, North Carolina",61862,31753,51.33%,48.67%,53.9,3366,5.44%,1498,1601,515,12253,5572,7923,5047,41247,12970,13751,7173,8438,22.23%,11.60%,14%,2829,59260,4.57%,95.43%,55685,656,308,360,1,156,
0500000US37089,"Henderson County, North Carolina",116298,60551,52.07%,47.94%,57.6,5038,4.33%,2873,3040,548,22361,9459,17369,9983,79320,27352,25234,12499,17917,21.70%,10.75%,15%,14999,101282,12.90%,87.10%,91747,3299,284,1296,241,400,
0500000US37091,"Hertford County, North Carolina",23752,11998,50.51%,49.49%,36.7,1499,6.31%,918,1258,154,5706,1647,1519,1135,13939,2654,6624,2905,1673,27.89%,12.23%,7%,1579,19973,6.65%,93.35%,6721,12215,188,113,3,99,
0500000US37093,"Hoke County, North Carolina",54590,27611,50.58%,49.42%,46.9,4693,8.60%,1731,1754,149,10394,4920,4432,2040,30843,6472,12125,6674,4581,22.21%,12.23%,8%,7687,44395,14.08%,85.92%,19667,16385,3803,716,189,336,
0500000US37095,"Hyde County, North Carolina",5089,2383,46.83%,53.17%,50.3,629,12.36%,60,90,0,1421,392,303,99,3014,402,1481,482,303,29.10%,9.47%,6%,347,4242,6.82%,93.18%,2928,1152,7,7,2,15,
0500000US37097,"Iredell County, North Carolina",178853,90674,50.70%,49.30%,54.3,7787,4.35%,5536,5699,1175,34043,13051,25574,11124,111584,36698,39579,18750,26749,22.13%,10.48%,15%,15777,170916,8.82%,91.18%,136393,21255,437,4718,58,656,
0500000US37099,"Jackson County, North Carolina",43435,22340,51.43%,48.57%,41.4,3378,7.78%,1129,6005,662,7874,3234,4402,3566,24664,7968,9003,9239,5064,20.73%,21.27%,12%,3292,39817,7.58%,92.42%,32800,736,3849,497,10,105,
0500000US37101,"Johnston County, North Carolina",203308,103486,50.90%,49.10%,52.7,9561,4.70%,5590,7345,612,37622,18188,23073,9411,119613,32484,43212,25533,23685,21.25%,12.56%,12%,34400,181599,16.92%,83.08%,136464,33041,880,1831,71,913,
0500000US37103,"Jones County, North Carolina",9453,4782,50.59%,49.41%,49.1,627,6.63%,165,228,51,2557,602,775,242,5890,1017,2722,830,826,28.80%,8.78%,9%,394,8778,4.17%,95.83%,5787,2564,42,32,0,35,
0500000US37105,"Lee County, North Carolina",61083,31572,51.69%,48.31%,47.2,4270,6.99%,1464,2348,323,11437,5182,5934,2549,35235,8483,12901,7530,6257,21.12%,12.33%,10%,13122,50163,21.48%,78.52%,36055,10701,231,643,43,227,
0500000US37107,"Lenoir County, North Carolina",56350,29170,51.77%,48.23%,43.6,4459,7.91%,1596,1482,349,12581,4794,4314,1783,31873,6097,14177,6276,4663,25.16%,11.14%,8%,4365,50757,7.75%,92.25%,26582,22034,134,332,22,135,
0500000US37109,"Lincoln County, North Carolina",84580,42747,50.54%,49.46%,55.2,3758,4.44%,2276,1958,556,18709,6759,9635,4401,54055,14036,20985,8717,10191,24.81%,10.31%,12%,6412,80398,7.58%,92.42%,71661,4405,237,692,15,208,
0500000US37111,"McDowell County, North Carolina",45402,22461,49.47%,50.53%,54.5,2345,5.16%,1188,1255,239,10580,4225,4315,1794,28093,6109,11768,5480,4554,25.92%,12.07%,10%,2947,41631,6.49%,93.51%,37788,1707,136,388,0,129,
0500000US37113,"Macon County, North Carolina",35172,18249,51.89%,48.12%,56.1,2340,6.65%,718,1011,142,8619,2459,4182,2167,23667,6349,9337,3470,4324,26.55%,9.87%,12%,3498,33516,9.95%,90.05%,31535,252,167,250,6,103,
0500000US37115,"Madison County, North Carolina",21608,10989,50.86%,49.14%,51.6,1207,5.59%,710,1024,157,5012,1139,2936,1758,13848,4694,5722,2163,3093,26.48%,10.01%,14%,748,20445,3.46%,96.54%,19233,197,56,84,1,73,
0500000US37117,"Martin County, North Carolina",22644,12105,53.46%,46.54%,44.9,2211,9.76%,603,469,105,5726,1918,1556,926,13668,2482,6329,2387,1661,27.95%,10.54%,7%,895,21136,3.95%,96.05%,11528,8868,69,98,1,64,
0500000US37119,"Mecklenburg County, North Carolina",1095170,568717,51.93%,48.07%,45,51528,4.71%,24937,44385,16837,122643,62112,223029,115561,668653,338590,147580,106497,239866,13.48%,9.72%,22%,169922,945560,15.52%,84.48%,498683,324832,2730,71583,531,6889,
0500000US37121,"Mitchell County, North Carolina",14959,7506,50.18%,49.82%,54.3,694,4.64%,262,629,65,3381,1075,1633,831,9628,2464,3643,1704,1698,24.35%,11.39%,11%,701,14202,4.69%,95.31%,13514,50,30,52,1,30,
0500000US37123,"Montgomery County, North Carolina",27223,13709,50.36%,49.64%,50.6,1840,6.76%,842,771,185,6626,1877,2135,973,15562,3108,7468,2648,2320,27.43%,9.73%,9%,3924,21827,14.41%,85.59%,16504,4192,76,391,2,47,
0500000US37125,"Moore County, North Carolina",99263,51477,51.86%,48.14%,55.5,3965,3.99%,1979,2737,509,15630,7962,17332,10539,66488,27871,17609,10699,17841,17.74%,10.78%,18%,7365,92362,7.42%,92.58%,75391,10545,688,1237,59,351,
0500000US37127,"Nash County, North Carolina",94287,49169,52.15%,47.85%,45.6,5388,5.71%,2915,3360,653,22188,7623,9570,4272,56458,13842,25103,10983,10223,26.62%,11.65%,11%,7322,87648,7.77%,92.23%,46317,36679,615,904,28,407,
0500000US37129,"New Hanover County, North Carolina",231448,121230,52.38%,47.62%,45.5,17254,7.45%,7841,15463,3605,31683,15993,44210,23020,148417,67230,39524,31456,47815,17.08%,13.59%,21%,17300,208402,7.47%,92.53%,167150,26974,678,3468,148,992,
0500000US37131,"Northampton County, North Carolina",19672,10076,51.22%,48.78%,43.3,1535,7.80%,538,423,0,5787,1373,1538,725,12139,2263,6325,1796,1538,32.15%,9.13%,8%,353,17118,1.79%,98.21%,6835,9649,43,27,4,76,
0500000US37133,"Onslow County, North Carolina",198377,88326,44.52%,55.48%,50.7,9698,4.89%,23258,17177,1269,31216,11619,17433,7683,98350,25116,54474,28796,18702,27.46%,14.52%,9%,27641,176935,13.93%,86.07%,129499,26939,1019,4508,777,1148,
0500000US37135,"Orange County, North Carolina",146354,76685,52.40%,47.60%,46.1,10533,7.20%,5394,15487,4355,11449,6112,23792,31753,84901,55545,16843,21599,28147,11.51%,14.76%,19%,15812,132884,10.80%,89.20%,96537,15571,334,12615,43,798,
0500000US37137,"Pamlico County, North Carolina",12673,6235,49.20%,50.80%,53.4,741,5.85%,371,276,36,2973,1053,1185,967,8861,2152,3344,1329,1221,26.39%,10.49%,10%,496,11780,3.91%,96.09%,9104,2055,58,50,5,51,
0500000US37139,"Pasquotank County, North Carolina",39775,20341,51.14%,48.86%,49.8,1516,3.81%,927,2281,203,8528,2531,3947,2395,24069,6342,9455,4812,4150,23.77%,12.10%,10%,2237,38331,5.62%,94.38%,21577,14316,150,458,28,178,
0500000US37141,"Pender County, North Carolina",61891,30885,49.90%,50.10%,51,3923,6.34%,1827,1616,162,11979,4314,8390,4226,38654,12616,13806,5930,8552,22.31%,9.58%,14%,4982,55221,8.05%,91.95%,44418,7544,195,319,23,243,
0500000US37143,"Perquimans County, North Carolina",13513,6992,51.74%,48.26%,57.9,898,6.65%,236,359,15,3138,821,1169,823,8818,1992,3374,1180,1184,24.97%,8.73%,9%,309,12696,2.29%,97.71%,9333,2686,35,36,7,41,
0500000US37145,"Person County, North Carolina",39561,20515,51.86%,48.14%,48.7,2111,5.34%,888,1312,152,10170,3432,3121,1323,24942,4444,11058,4744,3273,27.95%,11.99%,8%,2195,36902,5.55%,94.45%,25132,9879,240,124,8,121,
0500000US37147,"Pitt County, North Carolina",179961,95315,52.96%,47.04%,39.6,19811,11.01%,7049,18985,3714,26630,13166,22413,12936,98023,35349,33679,32151,26127,18.71%,17.87%,15%,12968,157275,7.21%,92.79%,86837,59813,494,3056,94,752,
0500000US37149,"Polk County, North Carolina",20682,10949,52.94%,47.06%,56,880,4.25%,390,414,107,4176,1698,3297,1968,14752,5265,4566,2112,3404,22.08%,10.21%,16%,1026,18302,4.96%,95.04%,16716,689,51,60,7,41,
0500000US37151,"Randolph County, North Carolina",143460,72630,50.63%,49.37%,52.2,9688,6.75%,3942,4537,526,34295,10009,11498,4573,82710,16071,38237,14546,12024,26.65%,10.14%,8%,19051,125120,13.28%,86.72%,108354,8592,666,2158,10,412,
0500000US37153,"Richmond County, North Carolina",44759,22868,51.09%,48.91%,42.5,4300,9.61%,1805,1082,175,9300,3498,3519,1924,25346,5443,11105,4580,3694,24.81%,10.23%,8%,3072,39874,6.86%,93.14%,23610,12770,994,360,7,167,
0500000US37155,"Robeson County, North Carolina",131656,68172,51.78%,48.22%,38.7,15497,11.77%,4965,5749,426,28299,8649,7949,4021,66204,11970,33264,14398,8375,25.27%,10.94%,6%,11757,104773,8.93%,91.07%,29159,26218,43536,897,63,411,
0500000US37157,"Rockingham County, North Carolina",91051,47333,51.99%,48.02%,51.9,6718,7.38%,2374,2785,227,22281,6738,6666,3353,54785,10019,24655,9523,6893,27.08%,10.46%,8%,6086,85010,6.68%,93.32%,64218,16611,282,493,29,287,
0500000US37159,"Rowan County, North Carolina",140978,71305,50.58%,49.42%,49.2,8383,5.95%,4546,5178,810,31767,9893,13975,5359,83739,19334,36313,15071,14785,25.76%,10.69%,10%,15940,130935,11.31%,88.69%,100135,22730,444,1505,71,535,
0500000US37161,"Rutherford County, North Carolina",66741,34400,51.54%,48.46%,48.1,4598,6.89%,1974,1620,470,15380,5528,6250,2997,40880,9247,17354,7148,6720,26.00%,10.71%,10%,3286,61158,4.92%,95.08%,52026,5836,152,343,23,210,
0500000US37163,"Sampson County, North Carolina",63284,32156,50.81%,49.19%,46.2,4561,7.21%,1734,2299,350,14874,4349,4318,1814,34400,6132,16608,6648,4668,26.24%,10.51%,7%,12249,46787,19.36%,80.64%,29729,13944,1002,216,18,156,
0500000US37165,"Scotland County, North Carolina",34921,17649,50.54%,49.46%,36.9,4544,13.01%,1121,1397,211,7943,2250,2405,1260,19127,3665,9064,3647,2616,25.96%,10.44%,7%,1106,33068,3.17%,96.83%,14247,13094,3705,339,15,112,
0500000US37167,"Stanly County, North Carolina",62050,31036,50.02%,49.98%,52.5,3872,6.24%,1796,2019,325,13944,5579,5526,2153,37663,7679,15740,7598,5851,25.37%,12.24%,9%,3086,59418,4.97%,95.03%,48645,7000,210,1140,9,131,
0500000US37169,"Stokes County, North Carolina",45688,23542,51.53%,48.47%,54.6,2550,5.58%,1502,1222,113,13685,3222,3093,1410,28684,4503,15187,4444,3206,33.24%,9.73%,7%,1456,43064,3.19%,96.81%,39609,1619,140,158,11,77,
0500000US37171,"Surry County, North Carolina",71904,37052,51.53%,48.47%,54,4800,6.68%,1947,2460,457,14843,5623,6234,2869,40696,9103,16790,8083,6691,23.35%,11.24%,9%,8496,62863,11.82%,88.18%,57771,2413,130,370,11,148,
0500000US37173,"Swain County, North Carolina",14241,7363,51.70%,48.30%,49.5,1135,7.97%,579,454,29,2927,1051,1225,793,8149,2018,3506,1505,1254,24.62%,10.57%,9%,592,13525,4.16%,95.84%,8541,102,4030,53,10,44,
0500000US37175,"Transylvania County, North Carolina",34039,17766,52.19%,47.81%,54.2,2135,6.27%,868,1313,87,6417,2419,5481,3330,23695,8811,7285,3732,5568,21.40%,10.96%,16%,1698,31288,4.99%,95.01%,28542,1027,102,173,22,115,
0500000US37177,"Tyrrell County, North Carolina",3978,1707,42.91%,57.09%,50.3,240,6.03%,150,137,97,1141,192,240,82,2336,322,1291,329,337,32.45%,8.27%,8%,272,2973,6.84%,93.16%,1879,934,5,43,0,13,
0500000US37179,"Union County, North Carolina",235767,119655,50.75%,49.25%,58.3,7617,3.23%,7341,8494,1966,35678,13507,37178,17219,135354,54397,43019,22001,39144,18.25%,9.33%,17%,30110,208157,12.77%,87.23%,161113,26500,641,9516,90,1199,
0500000US37181,"Vance County, North Carolina",44614,23831,53.42%,46.58%,39.3,4377,9.81%,1712,1149,160,10511,2685,3499,1789,25068,5288,12223,3834,3659,27.40%,8.59%,8%,3717,38861,8.33%,91.67%,16243,21081,91,284,9,110,
0500000US37183,"Wake County, North Carolina",1091662,560624,51.36%,48.65%,51.3,41185,3.77%,26398,41818,21772,107876,59034,244831,150169,683635,395000,134274,100852,266603,12.30%,9.24%,24%,128241,1001169,11.75%,88.25%,645020,204535,2760,96665,453,6210,
0500000US37185,"Warren County, North Carolina",19746,10097,51.13%,48.87%,39.9,1747,8.85%,581,703,64,5559,1275,1427,797,12156,2224,6140,1978,1491,31.09%,10.02%,8%,739,17903,3.74%,96.26%,7209,9049,953,62,4,65,
0500000US37187,"Washington County, North Carolina",11788,6188,52.49%,47.51%,37.1,1403,11.90%,528,358,10,2945,774,884,174,6922,1058,3473,1132,894,29.46%,9.60%,8%,371,10632,3.15%,96.85%,4958,5350,15,37,3,36,
0500000US37189,"Watauga County, North Carolina",55669,27905,50.13%,49.87%,39.6,7682,13.80%,1978,11958,1600,6857,2796,7628,6337,29617,13965,8835,14754,9228,15.87%,26.50%,17%,3521,50565,6.32%,93.68%,44986,2101,82,938,11,438,
0500000US37191,"Wayne County, North Carolina",123785,63185,51.04%,48.96%,46.2,9591,7.75%,3885,6063,507,24991,10271,11249,5081,70480,16330,28876,16334,11756,23.33%,13.20%,9%,14927,102406,12.06%,87.94%,60199,35329,335,1542,71,454,
0500000US37193,"Wilkes County, North Carolina",68341,34656,50.71%,49.29%,54.9,4296,6.29%,1455,2679,229,15554,5528,5480,2408,40161,7888,17009,8207,5709,24.89%,12.01%,8%,4654,61315,6.81%,93.19%,56316,2580,86,324,5,131,
0500000US37195,"Wilson County, North Carolina",81579,43115,52.85%,47.15%,45,6466,7.93%,2508,2303,620,18080,5065,7438,3716,45342,11154,20588,7368,8058,25.24%,9.03%,10%,9024,69760,11.06%,88.94%,36106,29842,239,900,10,257,
0500000US37197,"Yadkin County, North Carolina",37589,18962,50.45%,49.55%,55.8,2546,6.77%,1100,1119,219,9441,3211,2741,734,22809,3475,10541,4330,2960,28.04%,11.52%,8%,4382,32832,11.66%,88.34%,30357,1071,63,142,0,87,
0500000US37199,"Yancey County, North Carolina",17870,9050,50.64%,49.36%,59.3,1217,6.81%,421,636,42,4668,1229,1596,1110,11548,2706,5089,1865,1638,28.48%,10.44%,9%,1016,17454,5.69%,94.31%,16625,104,57,40,1,40,
0500000US38001,"Adams County, North Dakota",2271,1104,48.61%,51.39%,59.8,121,5.33%,28,55,9,586,169,220,160,1501,380,614,224,229,27.04%,9.86%,10%,36,2164,1.59%,98.41%,2028,12,14,39,1,0,
0500000US38003,"Barnes County, North Dakota",10592,5396,50.94%,49.06%,55.5,503,4.75%,233,588,65,2238,972,1688,598,7077,2286,2471,1560,1753,23.33%,14.73%,17%,185,10668,1.75%,98.25%,9964,177,92,69,2,24,
0500000US38005,"Benson County, North Dakota",6860,3389,49.40%,50.60%,40.1,1446,21.08%,212,220,10,1182,654,522,161,3427,683,1394,874,532,20.32%,12.74%,8%,89,5875,1.30%,98.70%,2532,2,3190,7,0,1,
0500000US38007,"Billings County, North Dakota",886,413,46.61%,53.39%,66.2,59,6.66%,44,5,0,243,92,126,41,587,167,287,97,126,32.39%,10.95%,14%,22,923,2.48%,97.52%,902,4,3,6,0,0,
0500000US38009,"Bottineau County, North Dakota",6418,3080,47.99%,52.01%,61.4,189,2.94%,147,288,103,1265,658,911,208,4195,1119,1412,946,1014,22.00%,14.74%,16%,141,6238,2.20%,97.80%,5688,31,197,42,1,13,
0500000US38011,"Bowman County, North Dakota",3091,1560,50.47%,49.53%,55.9,146,4.72%,92,76,5,757,304,304,106,1887,410,849,380,309,27.47%,12.29%,10%,129,2864,4.17%,95.83%,2760,0,34,17,3,0,
0500000US38013,"Burke County, North Dakota",2142,1013,47.29%,52.71%,65,30,1.40%,24,20,0,427,225,284,47,1433,331,451,245,284,21.06%,11.44%,13%,59,2142,2.75%,97.25%,2049,12,21,12,0,5,
0500000US38015,"Burleigh County, North Dakota",95509,47814,50.06%,49.94%,53.1,3905,4.09%,2962,4070,1096,14457,10196,16896,6649,60872,23545,17419,14266,17992,18.24%,14.94%,19%,3084,95374,3.23%,96.77%,84349,2227,4053,1043,316,210,
0500000US38017,"Cass County, North Dakota",179937,89119,49.53%,50.47%,50.4,7561,4.20%,5881,13573,4681,21631,16370,32106,14434,108535,46540,27512,29943,36787,15.29%,16.64%,20%,6182,178343,3.44%,96.56%,149442,12761,2367,6034,79,459,
0500000US38019,"Cavalier County, North Dakota",3769,1801,47.79%,52.22%,60.5,95,2.52%,154,71,58,722,372,498,117,2521,615,876,443,556,23.24%,11.75%,15%,45,3659,1.19%,98.81%,3485,2,28,16,0,15,
0500000US38021,"Dickey County, North Dakota",4857,2421,49.85%,50.15%,59.9,108,2.22%,141,216,41,877,576,683,224,3031,907,1018,792,724,20.96%,16.31%,15%,199,4800,4.10%,95.90%,4572,19,26,27,0,17,
0500000US38023,"Divide County, North Dakota",2289,1154,50.42%,49.59%,55.1,97,4.24%,65,17,0,500,294,229,40,1534,269,565,311,229,24.68%,13.59%,10%,53,2142,2.32%,97.68%,2024,23,17,11,4,3,
0500000US38025,"Dunn County, North Dakota",4362,2006,45.99%,54.01%,57.3,140,3.21%,115,97,0,1008,394,486,101,2729,587,1123,491,486,25.75%,11.26%,11%,107,3988,2.45%,97.55%,3241,23,455,32,0,10,
0500000US38027,"Eddy County, North Dakota",2262,1121,49.56%,50.44%,55.4,115,5.08%,104,4,23,499,217,271,92,1470,363,603,221,294,26.66%,9.77%,13%,77,2270,3.40%,96.60%,2102,5,60,0,0,0,
0500000US38029,"Emmons County, North Dakota",3262,1635,50.12%,49.88%,62.4,102,3.13%,17,69,75,844,267,360,110,2139,470,861,336,435,26.39%,10.30%,13%,35,3266,1.07%,98.93%,3162,0,13,12,0,8,
0500000US38031,"Foster County, North Dakota",3231,1632,50.51%,49.49%,62.5,72,2.23%,59,74,71,583,440,462,118,2110,580,642,514,533,19.87%,15.91%,16%,66,3331,2.04%,97.96%,3199,7,18,13,0,6,
0500000US38033,"Golden Valley County, North Dakota",1796,933,51.95%,48.05%,56.8,47,2.62%,37,34,2,369,186,241,79,1242,320,406,220,243,22.61%,12.25%,14%,48,1688,2.67%,97.33%,1600,5,12,1,1,4,
0500000US38035,"Grand Forks County, North Dakota",70243,33771,48.08%,51.92%,43.8,4914,7.00%,2930,8556,1897,9138,6002,10077,5033,39810,15110,12068,14558,11974,17.18%,20.73%,17%,3657,69513,5.21%,94.79%,58755,3009,1637,2479,52,169,
0500000US38037,"Grant County, North Dakota",2318,1146,49.44%,50.56%,62.8,83,3.58%,20,40,32,616,244,243,78,1557,321,636,284,275,27.44%,12.25%,12%,26,2275,1.12%,98.88%,2169,10,32,11,0,0,
0500000US38039,"Griggs County, North Dakota",2314,1162,50.22%,49.78%,57.1,40,1.73%,28,44,51,468,183,380,91,1558,471,496,227,431,21.43%,9.81%,19%,24,2282,1.04%,98.96%,2200,8,12,7,0,4,
0500000US38041,"Hettinger County, North Dakota",2510,1368,54.50%,45.50%,56.1,58,2.31%,13,85,8,619,209,229,69,1654,298,632,294,237,25.18%,11.71%,9%,34,2455,1.35%,98.65%,2319,5,42,5,7,8,
0500000US38043,"Kidder County, North Dakota",2468,1118,45.30%,54.70%,60.3,59,2.39%,95,68,4,635,198,249,50,1557,299,730,266,253,29.58%,10.78%,10%,52,2342,2.11%,97.89%,2271,3,11,1,5,0,
0500000US38045,"LaMoure County, North Dakota",4225,2058,48.71%,51.29%,65.7,245,5.80%,79,60,68,840,299,548,202,2597,750,919,359,616,21.75%,8.50%,15%,88,4005,2.08%,97.92%,3897,6,20,7,4,10,
0500000US38047,"Logan County, North Dakota",1743,836,47.96%,52.04%,64.8,44,2.52%,20,63,22,406,200,230,52,1136,282,426,263,252,24.44%,15.09%,14%,35,1841,2.01%,97.99%,1773,2,11,0,0,1,
0500000US38049,"McHenry County, North Dakota",5825,2839,48.74%,51.26%,62.4,184,3.16%,158,107,26,1282,654,687,152,3714,839,1440,761,713,24.72%,13.06%,12%,98,5247,1.68%,98.32%,5024,11,27,12,6,0,
0500000US38051,"McIntosh County, North Dakota",2535,1263,49.82%,50.18%,58.6,94,3.71%,18,38,58,652,314,196,98,1652,294,670,352,254,26.43%,13.89%,10%,53,2477,2.09%,97.91%,2375,7,5,23,0,8,
0500000US38053,"McKenzie County, North Dakota",13836,6259,45.24%,54.76%,45,637,4.60%,392,362,208,2601,850,1744,486,7590,2230,2993,1212,1952,21.63%,8.76%,14%,1532,13172,11.07%,88.93%,10268,214,1823,171,5,67,
0500000US38055,"McLean County, North Dakota",9531,4603,48.30%,51.71%,63.9,292,3.06%,179,227,58,2318,1134,1177,284,6372,1461,2497,1361,1235,26.20%,14.28%,13%,148,9623,1.55%,98.45%,8372,32,766,48,7,17,
0500000US38057,"Mercer County, North Dakota",8359,4107,49.13%,50.87%,65.1,512,6.13%,84,233,115,1571,1193,967,280,5394,1247,1655,1426,1082,19.80%,17.06%,13%,218,8132,2.61%,97.39%,7571,42,193,43,1,18,
0500000US38059,"Morton County, North Dakota",31118,15253,49.02%,50.98%,60.9,1096,3.52%,659,1003,421,6075,2858,4511,1430,20048,5941,6734,3861,4932,21.64%,12.41%,16%,1312,31979,4.22%,95.78%,28796,462,1238,171,39,74,
0500000US38061,"Mountrail County, North Dakota",10348,4792,46.31%,53.69%,52,497,4.80%,311,383,29,2184,859,1029,381,5910,1410,2495,1242,1058,24.11%,12.00%,10%,768,9041,7.42%,92.58%,5539,113,2737,105,3,34,
0500000US38063,"Nelson County, North Dakota",2864,1408,49.16%,50.84%,58.2,167,5.83%,49,80,19,648,323,477,99,2040,576,697,403,496,24.34%,14.07%,17%,69,2946,2.41%,97.59%,2844,6,16,9,1,5,
0500000US38065,"Oliver County, North Dakota",1962,939,47.86%,52.14%,74.1,96,4.89%,29,48,0,391,167,225,44,1266,269,420,215,225,21.41%,10.96%,11%,28,1849,1.43%,98.57%,1755,3,23,5,3,1,
0500000US38067,"Pembina County, North Dakota",6850,3306,48.26%,51.74%,60,176,2.57%,85,139,95,1536,742,833,254,4519,1087,1621,881,928,23.66%,12.86%,14%,243,6601,3.55%,96.45%,6096,27,133,27,0,22,
0500000US38069,"Pierce County, North Dakota",4061,2086,51.37%,48.63%,58.2,228,5.61%,21,104,87,939,335,502,315,2767,817,960,439,589,23.64%,10.81%,15%,72,3918,1.77%,98.23%,3611,36,146,17,5,10,
0500000US38071,"Ramsey County, North Dakota",11521,5708,49.54%,50.46%,51.2,815,7.07%,267,456,128,2089,1564,1528,532,7169,2060,2356,2020,1656,20.45%,17.53%,14%,274,11331,2.38%,97.62%,9354,73,1227,72,10,8,
0500000US38073,"Ransom County, North Dakota",5258,2525,48.02%,51.98%,60.2,287,5.46%,162,176,56,1349,507,628,139,3408,767,1511,683,684,28.74%,12.99%,13%,129,5574,2.45%,97.55%,5363,36,18,24,0,10,
0500000US38075,"Renville County, North Dakota",2387,1175,49.23%,50.78%,60.1,52,2.18%,81,24,54,549,202,296,69,1515,365,630,226,350,26.39%,9.47%,15%,37,2245,1.55%,98.45%,2146,5,14,0,0,2,
0500000US38077,"Richland County, North Dakota",16245,7846,48.30%,51.70%,50.9,919,5.66%,444,1507,99,2709,2181,1844,491,9678,2335,3153,3688,1943,19.41%,22.70%,12%,574,15955,3.53%,96.47%,14703,155,433,123,19,23,
0500000US38079,"Rolette County, North Dakota",14437,7313,50.66%,49.35%,37.7,2287,15.84%,363,461,134,2062,1435,1188,390,7379,1578,2425,1896,1322,16.80%,13.13%,9%,137,12050,0.95%,99.05%,2298,13,9210,23,8,8,
0500000US38081,"Sargent County, North Dakota",3899,1819,46.65%,53.35%,64.1,79,2.03%,137,83,40,1037,440,431,102,2696,533,1174,523,471,30.11%,13.41%,12%,91,3771,2.33%,97.67%,3570,48,8,13,0,0,
0500000US38083,"Sheridan County, North Dakota",1289,640,49.65%,50.35%,51.4,12,0.93%,32,23,0,394,93,142,10,861,152,426,116,142,33.05%,9.00%,11%,10,1255,0.78%,99.22%,1191,2,11,6,0,4,
0500000US38085,"Sioux County, North Dakota",4339,2154,49.64%,50.36%,28.9,892,20.56%,129,208,17,792,313,235,104,2007,339,921,521,252,21.23%,12.01%,6%,63,3835,1.45%,98.55%,401,3,3281,2,0,0,
0500000US38087,"Slope County, North Dakota",788,387,49.11%,50.89%,71.4,5,0.63%,17,9,8,168,121,121,29,528,150,185,130,129,23.48%,16.50%,16%,8,698,1.02%,98.98%,679,0,2,0,0,0,
0500000US38089,"Stark County, North Dakota",31164,15053,48.30%,51.70%,56.1,1892,6.07%,1079,1026,322,6604,2376,3607,1346,18645,4953,7683,3402,3929,24.65%,10.92%,13%,2274,31372,7.30%,92.70%,28307,1033,392,344,51,88,
0500000US38091,"Steele County, North Dakota",1817,877,48.27%,51.73%,63.6,148,8.15%,21,55,42,320,213,326,39,1251,365,341,268,368,18.77%,14.75%,20%,36,1762,1.98%,98.02%,1721,3,7,0,0,0,
0500000US38093,"Stutsman County, North Dakota",20879,10256,49.12%,50.88%,48.1,1219,5.84%,643,1164,258,5081,1237,2646,832,13192,3478,5724,2401,2904,27.42%,11.50%,14%,593,21000,2.84%,97.16%,19504,444,296,137,4,24,
0500000US38095,"Towner County, North Dakota",2191,958,43.72%,56.28%,56.1,56,2.56%,79,42,5,473,299,187,42,1412,229,552,341,192,25.19%,15.56%,9%,34,2128,1.55%,98.45%,1984,2,71,10,1,4,
0500000US38097,"Traill County, North Dakota",7999,3948,49.36%,50.64%,58.9,192,2.40%,231,400,48,1434,830,1168,484,5129,1652,1665,1230,1216,20.82%,15.38%,15%,297,7700,3.71%,96.29%,7311,48,60,18,4,10,
0500000US38099,"Walsh County, North Dakota",10642,5181,48.68%,51.32%,57.2,457,4.29%,306,201,88,2530,1013,961,349,6524,1310,2836,1214,1049,26.65%,11.41%,10%,1316,9247,12.37%,87.63%,8676,69,136,45,0,31,
0500000US38101,"Ward County, North Dakota",68962,32798,47.56%,52.44%,51.9,2861,4.15%,3403,3957,1001,13462,5176,8877,3749,41092,12626,16865,9133,9878,24.46%,13.24%,14%,4590,65329,6.66%,93.34%,55673,2853,1570,1087,129,250,
0500000US38103,"Wells County, North Dakota",3889,2039,52.43%,47.57%,59.3,108,2.78%,39,88,66,955,269,583,62,2619,645,994,357,649,25.56%,9.18%,17%,38,3944,0.98%,99.02%,3784,18,17,12,0,4,
0500000US38105,"Williams County, North Dakota",36044,16528,45.86%,54.15%,51.8,964,2.67%,1060,1226,181,6722,2827,4603,1239,20681,5842,7782,4053,4784,21.59%,11.24%,13%,3897,37053,10.81%,89.19%,30761,2041,1125,612,98,164,
0500000US39001,"Adams County, Ohio",27685,13889,50.17%,49.83%,49.8,1869,6.75%,1001,531,295,8305,1413,1604,1340,15655,2944,9306,1944,1899,33.61%,7.02%,7%,217,27260,0.78%,99.22%,26185,84,74,39,1,33,
0500000US39003,"Allen County, Ohio",102808,50858,49.47%,50.53%,44.7,5846,5.69%,3795,4392,405,27119,8047,7971,4931,62643,12902,30914,12439,8376,30.07%,12.10%,8%,3272,98934,3.18%,96.82%,79691,12475,233,835,42,541,
0500000US39005,"Ashland County, Ohio",53533,27429,51.24%,48.76%,52.5,2969,5.55%,2009,2917,209,15209,2582,5135,2711,32152,7846,17218,5499,5344,32.16%,10.27%,10%,862,51585,1.61%,98.39%,48948,383,82,322,33,103,
0500000US39007,"Ashtabula County, Ohio",97416,48561,49.85%,50.15%,46.5,7911,8.12%,3677,1996,349,29314,5501,7009,3212,58968,10221,32991,7497,7358,33.87%,7.70%,8%,4489,93085,4.61%,95.39%,84064,3492,154,338,12,260,
0500000US39009,"Athens County, Ohio",65945,33259,50.43%,49.57%,32.7,8883,13.47%,4429,13149,1151,12057,3199,5416,6432,33663,11848,16486,16348,6567,25.00%,24.79%,10%,1450,60981,2.20%,97.80%,54086,2768,223,1210,1,256,
0500000US39011,"Auglaize County, Ohio",45709,23102,50.54%,49.46%,58.9,1439,3.15%,1433,1428,275,13413,3652,3558,2403,28958,5961,14846,5080,3833,32.48%,11.11%,8%,781,45641,1.71%,98.29%,43643,231,76,242,40,71,
0500000US39013,"Belmont County, Ohio",67424,32939,48.85%,51.15%,47.7,3245,4.81%,2135,1530,238,21858,6203,5197,2856,45362,8053,23993,7733,5435,35.59%,11.47%,8%,824,65673,1.22%,98.78%,60536,2071,83,265,11,130,
0500000US39015,"Brown County, Ohio",43508,21887,50.31%,49.69%,54.4,2426,5.58%,1405,1305,147,13713,2691,2767,1590,26733,4357,15118,3996,2914,34.75%,9.18%,7%,487,43189,1.12%,98.88%,41053,302,68,84,2,111,
0500000US39017,"Butler County, Ohio",382129,194935,51.01%,48.99%,50.1,21862,5.72%,17013,22093,4128,80601,19305,50092,26607,224696,76699,97614,41398,54220,25.54%,10.83%,14%,25265,365092,6.61%,93.39%,294712,34144,610,15658,480,1546,
0500000US39019,"Carroll County, Ohio",27195,13502,49.65%,50.35%,56.6,1466,5.39%,819,566,201,9564,2090,1623,971,17458,2594,10383,2656,1824,38.18%,9.77%,7%,299,26422,1.10%,98.90%,25204,122,73,52,3,56,
0500000US39021,"Champaign County, Ohio",38861,19466,50.09%,49.91%,54.9,1765,4.54%,1459,1202,102,12364,2486,2783,1499,24564,4282,13823,3688,2885,35.57%,9.49%,7%,648,38066,1.67%,98.33%,35314,683,79,125,7,139,
0500000US39023,"Clark County, Ohio",134409,69272,51.54%,48.46%,47.2,9358,6.96%,5181,4683,632,35032,8606,10756,6667,81872,17423,40213,13289,11388,29.92%,9.89%,8%,5313,130688,3.95%,96.05%,109794,12074,314,898,91,538,
0500000US39025,"Clermont County, Ohio",205616,104355,50.75%,49.25%,54,9779,4.76%,7029,5532,1535,45549,13407,26016,15076,127754,41092,52578,18939,27551,25.57%,9.21%,13%,4956,203645,2.41%,97.59%,187749,3245,345,2529,58,611,
0500000US39027,"Clinton County, Ohio",42000,21253,50.60%,49.40%,52,2591,6.17%,1576,1736,213,10969,2798,3565,2120,25566,5685,12545,4534,3778,29.87%,10.80%,9%,765,41253,1.82%,98.18%,38247,819,96,205,6,165,
0500000US39029,"Columbiana County, Ohio",102514,50833,49.59%,50.41%,49.2,6144,5.99%,3375,2387,840,33081,7533,7041,3702,65962,10743,36456,9920,7881,35.56%,9.68%,8%,1752,100125,1.71%,98.29%,93466,2082,161,345,16,217,
0500000US39031,"Coshocton County, Ohio",36558,18597,50.87%,49.13%,54.4,2713,7.42%,1095,602,115,11139,2456,2483,1299,21745,3782,12234,3058,2598,33.46%,8.36%,7%,401,36211,1.10%,98.90%,34582,389,57,98,7,47,
0500000US39033,"Crawford County, Ohio",41603,21065,50.63%,49.37%,52.7,2223,5.34%,1439,1002,148,13571,3222,2926,1578,26574,4504,15010,4224,3074,36.08%,10.15%,7%,638,41387,1.53%,98.47%,39388,305,40,131,12,70,
0500000US39035,"Cuyahoga County, Ohio",1241475,649500,52.32%,47.68%,39.7,94753,7.63%,35121,42729,16709,242407,68845,170408,122294,791874,292702,277528,111574,187117,22.35%,8.99%,15%,83327,1181490,6.71%,93.29%,718753,365169,1827,43739,249,5745,
0500000US39037,"Darke County, Ohio",51387,25834,50.27%,49.73%,56,1995,3.88%,1837,1214,265,16453,2889,3483,1941,31810,5424,18290,4103,3748,35.59%,7.98%,7%,859,51022,1.67%,98.33%,48994,302,92,181,26,122,
0500000US39039,"Defiance County, Ohio",38024,19175,50.43%,49.57%,55.7,1196,3.15%,1439,1456,174,10753,2816,3063,1718,23838,4781,12192,4272,3237,32.06%,11.24%,9%,3950,34336,10.39%,89.61%,32276,598,79,133,15,88,
0500000US39041,"Delaware County, Ohio",205454,103501,50.38%,49.62%,61.2,3999,1.95%,5804,6812,2070,23671,9061,45688,29231,130626,74919,29475,15873,47758,14.35%,7.73%,23%,7012,207112,3.41%,96.59%,171420,7702,242,18158,60,823,
0500000US39043,"Erie County, Ohio",74419,38061,51.14%,48.86%,50,4027,5.41%,2541,1955,618,18825,5492,8482,4833,49319,13315,21366,7447,9100,28.71%,10.01%,12%,3130,72492,4.21%,95.79%,61061,6655,121,474,10,232,
0500000US39045,"Fairfield County, Ohio",156204,78449,50.22%,49.78%,53.2,5238,3.35%,5425,4307,1043,34898,9639,19871,10835,98808,30706,40323,13946,20914,25.81%,8.93%,13%,4021,154900,2.57%,97.43%,130664,13302,287,3063,31,515,
0500000US39047,"Fayette County, Ohio",28609,14660,51.24%,48.76%,50.5,2187,7.64%,1033,761,181,8845,1324,1990,998,16441,2988,9878,2085,2171,34.53%,7.29%,8%,681,28270,2.38%,97.62%,26260,521,43,171,11,88,
0500000US39049,"Franklin County, Ohio",1304715,667713,51.18%,48.82%,42.4,86233,6.61%,33796,58561,20800,213557,61272,220763,131752,795891,352515,247353,119833,241563,18.96%,9.18%,19%,91182,1232625,6.99%,93.01%,787615,296076,2160,73714,444,7212,
0500000US39051,"Fulton County, Ohio",42186,21347,50.60%,49.40%,55.4,1556,3.69%,1449,1001,431,12283,3404,3264,1655,26742,4919,13732,4405,3695,32.55%,10.44%,9%,3791,38922,8.99%,91.01%,36968,225,60,152,6,120,
0500000US39053,"Gallia County, Ohio",29995,15160,50.54%,49.46%,53.5,1705,5.68%,837,936,299,8559,2041,2029,1553,17729,3582,9396,2977,2328,31.33%,9.92%,8%,262,28958,0.87%,99.13%,26955,597,55,148,5,79,
0500000US39055,"Geauga County, Ohio",93657,47205,50.40%,49.60%,61.2,2460,2.63%,2390,2364,877,16614,4813,15677,8682,58265,24359,19004,7177,16554,20.29%,7.66%,18%,1664,93733,1.78%,98.22%,88958,1075,36,666,8,220,
0500000US39057,"Greene County, Ohio",167867,85237,50.78%,49.22%,51.3,8274,4.93%,4101,12234,2422,26625,10820,23427,21524,106571,44951,30726,23054,25849,18.30%,13.73%,15%,5216,162750,3.11%,96.89%,135603,11285,330,5516,87,876,
0500000US39059,"Guernsey County, Ohio",38996,19578,50.21%,49.80%,48.6,3280,8.41%,1080,1353,124,11361,2681,2622,1496,23163,4118,12441,4034,2746,31.90%,10.34%,7%,444,37994,1.14%,98.86%,35717,520,87,149,7,65,
0500000US39061,"Hamilton County, Ohio",815790,421839,51.71%,48.29%,43.2,55754,6.83%,27501,29302,11445,142189,46022,129331,85317,506630,214648,169690,75324,140776,20.80%,9.23%,17%,36250,794389,4.44%,95.56%,519734,207764,1173,25160,618,3959,
0500000US39063,"Hancock County, Ohio",75765,38412,50.70%,49.30%,49.4,3226,4.26%,2169,3182,872,18775,4688,8962,5414,48517,14376,20944,7870,9834,27.64%,10.39%,13%,4198,70722,5.54%,94.46%,65107,1363,79,1393,26,220,
0500000US39065,"Hardin County, Ohio",31393,15822,50.40%,49.60%,50.7,1811,5.77%,1800,2606,214,9462,1428,1912,1177,17397,3089,11262,4034,2126,35.87%,12.85%,7%,697,29999,2.22%,97.78%,28389,256,48,169,8,69,
0500000US39067,"Harrison County, Ohio",15132,7708,50.94%,49.06%,53.5,1029,6.80%,549,271,44,5382,1246,844,509,9598,1353,5931,1517,888,39.20%,10.03%,6%,130,14353,0.86%,99.14%,13425,234,14,40,6,18,
0500000US39069,"Henry County, Ohio",27068,13731,50.73%,49.27%,53,938,3.47%,1151,553,73,8219,2302,2185,1116,17510,3301,9370,2855,2258,34.62%,10.55%,8%,2187,25475,8.08%,91.92%,24463,155,49,125,4,43,
0500000US39071,"Highland County, Ohio",43080,22033,51.14%,48.86%,54.1,2848,6.61%,1484,816,128,12866,3098,2275,1791,24836,4066,14350,3914,2403,33.31%,9.09%,6%,424,42893,0.98%,99.02%,40492,518,109,110,8,96,
0500000US39073,"Hocking County, Ohio",28306,14313,50.57%,49.44%,55.3,1914,6.76%,1094,586,120,8767,2228,1872,901,17671,2773,9861,2814,1992,34.84%,9.94%,7%,232,27818,0.82%,99.18%,26502,139,45,71,0,53,
0500000US39075,"Holmes County, Ohio",43954,22055,50.18%,49.82%,56.9,1557,3.54%,1213,420,70,8379,942,1824,868,14564,2692,9592,1362,1894,21.82%,3.10%,4%,474,43749,1.08%,98.92%,42875,119,33,64,5,41,
0500000US39077,"Huron County, Ohio",58271,29492,50.61%,49.39%,50.9,2990,5.13%,2025,1411,254,17997,3694,3908,1943,35395,5851,20022,5105,4162,34.36%,8.76%,7%,4084,54481,7.01%,92.99%,51242,562,139,216,12,106,
0500000US39079,"Jackson County, Ohio",32440,16534,50.97%,49.03%,54.6,2046,6.31%,1347,759,30,10081,2322,2271,1035,19262,3306,11428,3081,2301,35.23%,9.50%,7%,306,32347,0.94%,99.06%,30835,158,88,101,1,50,
0500000US39081,"Jefferson County, Ohio",65943,33750,51.18%,48.82%,48.2,5153,7.81%,2496,2564,514,20711,5715,5309,2931,43064,8240,23207,8279,5823,35.19%,12.55%,9%,1159,64090,1.76%,98.24%,56545,3619,109,338,29,244,
0500000US39083,"Knox County, Ohio",61776,31693,51.30%,48.70%,54.1,3448,5.58%,2440,3511,546,15790,3365,6127,3045,37249,9172,18230,6876,6673,29.51%,11.13%,11%,1196,61525,1.94%,98.06%,58058,565,118,365,17,237,
0500000US39085,"Lake County, Ohio",229755,117587,51.18%,48.82%,49.8,7249,3.16%,6111,7449,2086,52110,16479,29620,17347,153540,46967,58221,23928,31706,25.34%,10.41%,14%,11362,221241,4.95%,95.05%,197069,10778,236,3255,38,604,
0500000US39087,"Lawrence County, Ohio",59901,30696,51.25%,48.76%,47.7,4581,7.65%,2179,1378,195,18628,3833,4495,2183,37001,6678,20807,5211,4690,34.74%,8.70%,8%,618,57622,1.03%,98.97%,54016,1100,134,219,7,135,
0500000US39089,"Licking County, Ohio",175409,89447,50.99%,49.01%,52.9,7836,4.47%,6320,6631,1226,40570,11830,22107,10680,109991,32787,46890,18461,23333,26.73%,10.52%,13%,3988,174531,2.27%,97.73%,152935,7142,386,4999,45,787,
0500000US39091,"Logan County, Ohio",45315,22761,50.23%,49.77%,58,2334,5.15%,1739,1047,387,14226,3076,3567,1772,28957,5339,15965,4123,3954,35.23%,9.10%,9%,1004,45146,2.22%,97.78%,41749,673,83,327,11,181,
0500000US39093,"Lorain County, Ohio",309134,156993,50.79%,49.22%,48.2,18380,5.95%,9388,11160,2076,65930,23695,34348,19995,193067,54343,75318,34855,36424,24.36%,11.28%,12%,32917,280047,10.65%,89.35%,237520,22980,502,3569,50,1020,
0500000US39095,"Lucas County, Ohio",430319,221922,51.57%,48.43%,41.8,39094,9.08%,11839,17037,3715,86344,30543,48782,29377,262797,78159,98183,47580,52497,22.82%,11.06%,12%,32167,399112,7.48%,92.52%,284663,83398,817,7089,115,1926,
0500000US39097,"Madison County, Ohio",44248,20146,45.53%,54.47%,44.3,1821,4.12%,1462,1054,188,13019,2386,3920,1844,27813,5764,14481,3440,4108,32.73%,7.77%,9%,1263,42561,2.85%,97.15%,37761,2664,59,253,4,176,
0500000US39099,"Mahoning County, Ohio",228452,116543,51.01%,48.99%,44.5,16429,7.19%,7511,6969,1526,60845,12712,26348,13937,149050,40285,68356,19681,27874,29.92%,8.61%,12%,14093,214521,6.17%,93.83%,169090,33770,332,1952,59,708,
0500000US39101,"Marion County, Ohio",65179,30418,46.67%,53.33%,45.9,4677,7.18%,2370,1600,214,20686,3494,3889,2088,41531,5977,23056,5094,4103,35.37%,7.82%,6%,1956,63403,3.00%,97.00%,56114,4051,140,358,15,167,
0500000US39103,"Medina County, Ohio",179116,90515,50.53%,49.47%,57.3,4399,2.46%,4692,5244,1638,38556,12101,28100,14507,119043,42607,43248,17345,29738,24.15%,9.68%,17%,4592,177878,2.56%,97.44%,165643,2292,192,2184,28,589,
0500000US39105,"Meigs County, Ohio",22974,11493,50.03%,49.97%,48.1,1737,7.56%,530,620,75,7226,1775,1215,763,13696,1978,7756,2395,1290,33.76%,10.42%,6%,172,22038,0.75%,99.25%,21180,148,49,22,0,43,
0500000US39107,"Mercer County, Ohio",41034,20335,49.56%,50.44%,58.7,842,2.05%,1619,1114,210,11873,3248,3413,1843,25031,5256,13492,4362,3623,32.88%,10.63%,9%,928,41600,2.26%,97.74%,39752,191,63,189,564,78,
0500000US39109,"Miami County, Ohio",106074,53519,50.45%,49.55%,52.5,3929,3.70%,3201,2704,912,27725,7203,10465,6228,67783,16693,30926,9907,11377,29.16%,9.34%,11%,2199,106575,2.07%,97.93%,96964,2559,152,1644,21,483,
0500000US39111,"Monroe County, Ohio",13827,6881,49.77%,50.24%,57.6,822,5.94%,360,368,62,5091,1113,721,493,9081,1214,5451,1481,783,39.42%,10.71%,6%,67,13318,0.48%,99.52%,12909,19,12,21,3,19,
0500000US39113,"Montgomery County, Ohio",531988,275926,51.87%,48.13%,43.7,36653,6.89%,14323,24377,4712,101507,37230,63481,40002,330740,103483,115830,61607,68193,21.77%,11.58%,13%,21179,516130,3.98%,96.02%,360396,112818,937,12714,244,2588,
0500000US39115,"Morgan County, Ohio",14557,7335,50.39%,49.61%,52.7,975,6.70%,612,210,62,4730,1247,724,371,9002,1095,5342,1457,786,36.70%,10.01%,5%,127,13675,0.87%,99.13%,12525,396,20,24,2,49,
0500000US39117,"Morrow County, Ohio",35148,17561,49.96%,50.04%,54.9,1095,3.12%,1200,587,30,10926,1970,2507,1104,21663,3611,12126,2557,2537,34.50%,7.27%,7%,580,34370,1.65%,98.35%,32773,153,56,90,8,93,
0500000US39119,"Muskingum County, Ohio",86033,44165,51.34%,48.67%,46.6,6006,6.98%,3398,3159,376,24912,6164,6334,3953,52233,10287,28310,9323,6710,32.91%,10.84%,8%,1055,85355,1.23%,98.77%,76947,2985,138,384,8,378,
0500000US39121,"Noble County, Ohio",14410,5928,41.14%,58.86%,47.2,610,4.23%,235,269,33,5256,940,828,386,9171,1214,5491,1209,861,38.11%,8.39%,6%,173,13942,1.20%,98.80%,12840,752,31,22,0,11,
0500000US39123,"Ottawa County, Ohio",40557,20288,50.02%,49.98%,56,1756,4.33%,834,1111,189,11043,2841,4942,2356,28079,7298,11877,3952,5131,29.28%,9.74%,13%,2059,38305,5.08%,94.92%,36436,335,47,157,6,92,
0500000US39125,"Paulding County, Ohio",18742,9380,50.05%,49.95%,56.9,757,4.04%,508,440,45,5847,1161,1515,549,11663,2064,6355,1601,1560,33.91%,8.54%,8%,1010,17796,5.39%,94.61%,16972,139,41,30,5,61,
0500000US39127,"Perry County, Ohio",36076,18026,49.97%,50.03%,51.3,2638,7.31%,1493,664,119,11746,2208,2135,1100,21696,3235,13239,2872,2254,36.70%,7.96%,6%,252,35156,0.70%,99.30%,33595,90,94,67,0,85,
0500000US39129,"Pickaway County, Ohio",58112,27694,47.66%,52.34%,48.2,3609,6.21%,2387,1747,213,16975,3021,4935,2620,35280,7555,19362,4768,5148,33.32%,8.20%,9%,903,57636,1.55%,98.45%,52416,2143,131,296,11,153,
0500000US39131,"Pike County, Ohio",27914,14154,50.71%,49.29%,52.4,2007,7.19%,781,754,77,8480,1383,1674,1067,16177,2741,9261,2137,1751,33.18%,7.66%,6%,219,26869,0.78%,99.22%,25470,190,110,70,6,44,
0500000US39133,"Portage County, Ohio",162476,82748,50.93%,49.07%,46,7629,4.70%,6128,15674,2717,39223,8580,18994,12686,98133,31680,45351,24254,21711,27.91%,14.93%,13%,3505,158286,2.16%,97.84%,138774,7934,233,3400,38,558,
0500000US39135,"Preble County, Ohio",40995,20579,50.20%,49.80%,57.4,1333,3.25%,1428,996,215,12443,2464,3330,1927,26094,5257,13871,3460,3545,33.84%,8.44%,9%,386,40613,0.94%,99.06%,38700,182,84,162,4,98,
0500000US39137,"Putnam County, Ohio",33836,16923,50.02%,49.99%,63.3,1013,2.99%,698,1150,273,9195,3136,3473,1779,21252,5252,9893,4286,3746,29.24%,12.67%,11%,2229,32222,6.59%,93.41%,31427,100,25,61,3,61,
0500000US39139,"Richland County, Ohio",121043,59557,49.20%,50.80%,47.7,6389,5.28%,4059,3514,608,34269,7685,9954,5104,74403,15058,38328,11199,10562,31.66%,9.25%,9%,2615,122321,2.16%,97.84%,104231,11216,192,791,58,473,
0500000US39141,"Ross County, Ohio",76816,36752,47.84%,52.16%,48.4,4863,6.33%,2744,1631,323,24215,4436,5550,3259,48441,8809,26959,6067,5873,35.10%,7.90%,8%,1031,76062,1.34%,98.66%,67705,4005,189,369,20,196,
0500000US39143,"Sandusky County, Ohio",58801,29440,50.07%,49.93%,50.3,3636,6.18%,2089,1385,310,17502,4482,4442,2317,37581,6759,19591,5867,4752,33.32%,9.98%,8%,6055,52841,10.30%,89.70%,48219,1762,75,202,7,159,
0500000US39145,"Scioto County, Ohio",75441,38351,50.84%,49.16%,47,7683,10.18%,2658,2281,277,22358,4264,4769,3450,45127,8219,25016,6545,5046,33.16%,8.68%,7%,1052,72956,1.39%,98.61%,67531,2038,254,274,9,210,
0500000US39147,"Seneca County, Ohio",55251,27493,49.76%,50.24%,47.1,2970,5.38%,2074,2814,389,16719,3790,4233,2234,34332,6467,18793,6604,4622,34.01%,11.95%,8%,2899,52170,5.25%,94.75%,48213,1314,66,359,36,158,
0500000US39149,"Shelby County, Ohio",48610,24173,49.73%,50.27%,54.7,1568,3.23%,1801,1168,300,13393,3578,3994,2272,29133,6266,15194,4746,4294,31.26%,9.76%,9%,787,47443,1.62%,98.38%,44067,839,81,450,29,188,
0500000US39151,"Stark County, Ohio",371516,190987,51.41%,48.59%,48.3,20096,5.41%,12244,13427,2572,99003,21986,39560,21552,239493,61112,111247,35413,42132,29.94%,9.53%,11%,10516,364337,2.83%,97.17%,310535,28723,721,3175,97,1651,
0500000US39153,"Summit County, Ohio",540810,278622,51.52%,48.48%,46.8,30411,5.62%,15749,18894,5341,114225,31745,79633,45330,351378,124963,129974,50639,84974,24.03%,9.36%,16%,13206,527222,2.44%,97.56%,397536,78922,777,22506,149,2096,
0500000US39155,"Trumbull County, Ohio",199144,102228,51.33%,48.67%,46.3,14476,7.27%,6542,4609,1053,62877,10605,18353,9066,127797,27419,69419,15214,19406,34.86%,7.64%,10%,4179,197798,2.10%,97.90%,169627,16940,249,1099,26,609,
0500000US39157,"Tuscarawas County, Ohio",92165,46693,50.66%,49.34%,53.8,5131,5.57%,3350,1735,484,28820,4461,7522,3863,55527,11385,32170,6196,8006,34.90%,6.72%,9%,3962,89301,4.30%,95.70%,84979,697,117,306,29,169,
0500000US39159,"Union County, Ohio",57871,30084,51.99%,48.02%,55.3,1069,1.85%,1757,1443,524,12605,2678,9284,4639,36917,13923,14362,4121,9808,24.82%,7.12%,17%,1534,61250,2.65%,97.35%,53287,1275,93,4043,0,201,
0500000US39161,"Van Wert County, Ohio",28213,14345,50.85%,49.16%,58.2,1273,4.51%,923,764,154,8534,2363,2037,1311,17961,3348,9457,3127,2191,33.52%,11.08%,8%,1097,27834,3.89%,96.11%,26467,257,37,88,13,79,
0500000US39163,"Vinton County, Ohio",13045,6495,49.79%,50.21%,51.4,788,6.04%,464,183,0,3839,838,866,310,7245,1176,4303,1021,866,32.99%,7.83%,7%,84,12716,0.64%,99.36%,12213,43,19,22,0,14,
0500000US39165,"Warren County, Ohio",232540,115335,49.60%,50.40%,59.4,5258,2.26%,7399,5933,1916,40433,13388,41853,26828,147832,68681,47832,19321,43769,20.57%,8.31%,19%,7738,234599,3.33%,96.67%,198227,8175,288,17278,158,704,
0500000US39167,"Washington County, Ohio",60217,30425,50.53%,49.47%,50.9,3062,5.08%,1912,2253,280,17245,4937,4831,3239,39151,8070,19157,7190,5111,31.81%,11.94%,8%,717,59054,1.19%,98.81%,55663,600,114,309,8,158,
0500000US39169,"Wayne County, Ohio",116063,58502,50.41%,49.60%,55.1,4274,3.68%,3661,4956,674,29885,5636,10772,6475,66403,17247,33546,10592,11446,28.90%,9.13%,10%,2755,114139,2.37%,97.63%,106930,1755,142,950,32,283,
0500000US39171,"Williams County, Ohio",36760,18558,50.48%,49.52%,50.4,1763,4.80%,1434,739,213,10833,2711,2517,1345,23403,3862,12267,3450,2730,33.37%,9.39%,7%,1862,35240,5.07%,94.93%,33483,323,55,198,0,92,
0500000US39173,"Wood County, Ohio",130662,66334,50.77%,49.23%,44.7,7547,5.78%,4205,14997,2423,24748,8082,16738,11175,77180,27913,28953,23079,19161,22.16%,17.66%,15%,8280,123968,6.34%,93.66%,112493,3089,164,2750,9,330,
0500000US39175,"Wyandot County, Ohio",21907,11138,50.84%,49.16%,56.5,599,2.73%,765,620,132,6928,1660,1878,1083,14233,2961,7693,2280,2010,35.12%,10.41%,9%,641,21259,2.93%,97.07%,20520,77,21,85,3,45,
0500000US40001,"Adair County, Oklahoma",22171,11039,49.79%,50.21%,48.9,2517,11.35%,985,427,54,6561,732,1071,474,11632,1545,7546,1159,1125,34.04%,5.23%,5%,1252,18243,5.65%,94.35%,7464,40,8240,162,12,12,
0500000US40003,"Alfalfa County, Oklahoma",5791,2307,39.84%,60.16%,49.2,147,2.54%,181,73,52,1485,320,677,288,3707,965,1666,393,729,28.77%,6.79%,13%,279,5420,4.82%,95.18%,4702,229,194,7,0,7,
0500000US40005,"Atoka County, Oklahoma",13815,6579,47.62%,52.38%,52.9,750,5.43%,506,259,47,3825,625,1116,467,8070,1583,4331,884,1163,31.35%,6.40%,8%,548,13595,3.97%,96.03%,9303,565,2192,49,4,58,
0500000US40007,"Beaver County, Oklahoma",5326,2652,49.79%,50.21%,58,222,4.17%,145,131,17,1111,201,647,177,3011,824,1256,332,664,23.58%,6.23%,12%,1304,3745,24.48%,75.52%,3497,3,29,11,6,3,
0500000US40009,"Beckham County, Oklahoma",21860,9934,45.44%,54.56%,45.7,1568,7.17%,990,481,104,4966,1132,1669,749,12192,2418,5956,1613,1773,27.25%,7.38%,8%,2684,19726,12.28%,87.72%,16526,1119,770,128,12,38,
0500000US40011,"Blaine County, Oklahoma",9521,4323,45.41%,54.60%,51.5,266,2.79%,180,239,20,2440,431,1021,334,5840,1355,2620,670,1041,27.52%,7.04%,11%,985,7750,10.35%,89.65%,6248,248,650,26,5,12,
0500000US40013,"Bryan County, Oklahoma",47325,24313,51.38%,48.63%,47.8,3087,6.52%,1563,2222,218,10803,1991,4674,2491,27635,7165,12366,4213,4892,26.13%,8.90%,10%,3428,42639,7.24%,92.76%,30076,715,6574,285,14,73,
0500000US40015,"Caddo County, Oklahoma",29179,13784,47.24%,52.76%,47.2,2110,7.23%,973,689,77,8284,1165,2223,764,16806,2987,9257,1854,2300,31.72%,6.35%,8%,4335,22610,14.86%,85.14%,14580,646,5320,63,13,29,
0500000US40017,"Canadian County, Oklahoma",144610,72841,50.37%,49.63%,52.9,4547,3.14%,4133,4279,956,28377,9204,19082,8180,87592,27262,32510,13483,20038,22.48%,9.32%,14%,16377,138028,11.32%,88.68%,107898,5307,6312,4782,114,478,
0500000US40019,"Carter County, Oklahoma",48380,24789,51.24%,48.76%,48.2,3150,6.51%,1768,949,265,11809,2447,3894,2659,28366,6553,13577,3396,4159,28.06%,7.02%,9%,3622,44381,7.49%,92.51%,31227,2824,4203,587,44,655,
0500000US40021,"Cherokee County, Oklahoma",48871,25021,51.20%,48.80%,44.9,4587,9.39%,2205,3828,338,9668,1773,5350,3136,27022,8486,11873,5601,5688,24.29%,11.46%,12%,3437,43641,7.03%,92.97%,20231,519,15745,308,21,139,
0500000US40023,"Choctaw County, Oklahoma",14727,7662,52.03%,47.97%,49.1,1563,10.61%,457,289,23,4077,664,882,478,8430,1360,4534,953,905,30.79%,6.47%,6%,595,13609,4.04%,95.96%,8114,1371,2502,29,4,57,
0500000US40025,"Cimarron County, Oklahoma",2159,1086,50.30%,49.70%,62.7,97,4.49%,31,23,0,509,56,364,46,1297,410,540,79,364,25.01%,3.66%,17%,563,1733,26.08%,73.92%,1647,1,4,0,0,7,
0500000US40027,"Cleveland County, Oklahoma",282189,141401,50.11%,49.89%,47.9,17769,6.30%,9276,23551,4949,44070,15627,38286,23626,166646,61912,53346,39178,43235,18.90%,13.88%,15%,30312,265216,10.74%,89.26%,195085,14613,12133,12697,237,1866,
0500000US40029,"Coal County, Oklahoma",5577,2769,49.65%,50.35%,51.9,324,5.81%,200,138,30,1640,170,378,270,3189,648,1840,308,408,32.99%,5.52%,7%,198,5068,3.55%,96.45%,3371,23,1009,15,0,48,
0500000US40031,"Comanche County, Oklahoma",121374,58658,48.33%,51.67%,44.4,7532,6.21%,7022,5577,1058,25536,5953,10627,7354,70392,17981,32558,11530,11685,26.82%,9.50%,10%,16645,104480,13.71%,86.29%,64465,18871,6381,2994,803,526,
0500000US40033,"Cotton County, Oklahoma",5783,2827,48.89%,51.12%,54.7,352,6.09%,202,118,69,1725,116,352,253,3369,605,1927,234,421,33.32%,4.05%,7%,361,5166,6.24%,93.76%,4098,68,481,28,9,9,
0500000US40035,"Craig County, Oklahoma",14274,6990,48.97%,51.03%,49.2,942,6.60%,457,457,35,4014,1041,955,490,8823,1445,4471,1498,990,31.32%,10.49%,7%,427,13680,2.99%,97.01%,8438,368,2833,75,1,31,
0500000US40037,"Creek County, Oklahoma",71505,36136,50.54%,49.46%,51.7,4577,6.40%,2577,1615,216,19957,4039,5441,2413,43708,7854,22534,5654,5657,31.51%,7.91%,8%,3412,68342,4.77%,95.23%,51528,1452,7002,290,67,141,
0500000US40039,"Custer County, Oklahoma",28929,14742,50.96%,49.04%,45.9,2229,7.71%,1014,2853,354,5095,1207,3103,1446,15095,4549,6109,4060,3457,21.12%,14.03%,12%,5384,23129,18.61%,81.39%,18483,783,1702,294,1,57,
0500000US40041,"Delaware County, Oklahoma",42741,21714,50.80%,49.20%,53.1,3011,7.04%,1221,1054,103,11541,2338,3815,1814,26405,5629,12762,3392,3918,29.86%,7.94%,9%,1621,38776,3.79%,96.21%,25019,116,8491,471,36,85,
0500000US40043,"Dewey County, Oklahoma",4885,2485,50.87%,49.13%,52.3,86,1.76%,84,216,17,1319,187,451,215,2986,666,1403,403,468,28.72%,8.25%,10%,260,4224,5.32%,94.68%,3723,7,247,4,2,4,
0500000US40045,"Ellis County, Oklahoma",3936,2018,51.27%,48.73%,52.9,291,7.39%,108,104,0,880,230,429,134,2377,563,988,334,429,25.10%,8.49%,11%,340,3409,8.64%,91.36%,3148,16,57,9,0,3,
0500000US40047,"Garfield County, Oklahoma",61555,31004,50.37%,49.63%,50.6,3336,5.42%,2408,1846,489,14556,3501,6593,2873,35386,9466,16964,5347,7082,27.56%,8.69%,12%,8982,53864,14.59%,85.41%,42939,1661,1307,685,2920,150,
0500000US40049,"Garvin County, Oklahoma",27789,13990,50.34%,49.66%,49.5,2117,7.62%,1120,603,56,8230,738,2024,915,16180,2939,9350,1341,2080,33.65%,4.83%,7%,2452,23204,8.82%,91.18%,18200,545,2066,118,8,39,
0500000US40051,"Grady County, Oklahoma",55315,27685,50.05%,49.95%,56.8,2038,3.68%,1964,1590,249,15260,2665,6043,2010,33865,8053,17224,4255,6292,31.14%,7.69%,11%,3520,51275,6.36%,93.64%,41842,1281,2897,200,38,112,
0500000US40053,"Grant County, Oklahoma",4369,2204,50.45%,49.55%,54,226,5.17%,170,86,36,1052,300,468,193,2684,661,1222,386,504,27.97%,8.83%,12%,184,3985,4.21%,95.79%,3632,44,79,12,8,15,
0500000US40055,"Greer County, Oklahoma",5790,2519,43.51%,56.49%,42.4,474,8.19%,198,101,0,1404,339,453,54,3457,507,1602,440,453,27.67%,7.60%,8%,665,4826,11.49%,88.51%,3996,352,167,7,1,15,
0500000US40057,"Harmon County, Oklahoma",2663,1351,50.73%,49.27%,57.7,172,6.46%,76,35,8,567,79,265,68,1517,333,643,114,273,24.15%,4.28%,10%,740,1748,27.79%,72.21%,1403,149,53,7,0,0,
0500000US40059,"Harper County, Oklahoma",3730,1902,50.99%,49.01%,63.1,140,3.75%,111,90,0,732,115,353,149,2150,502,843,205,353,22.60%,5.50%,9%,733,2539,19.65%,80.35%,2375,4,24,0,0,2,
0500000US40061,"Haskell County, Oklahoma",12688,6422,50.62%,49.39%,55.9,883,6.96%,370,305,41,3464,899,989,369,7441,1358,3834,1204,1030,30.22%,9.49%,8%,529,11032,4.17%,95.83%,7697,64,2153,21,7,26,
0500000US40063,"Hughes County, Oklahoma",13265,6246,47.09%,52.91%,39.9,1029,7.76%,465,355,25,3595,611,797,539,7479,1336,4060,966,822,30.61%,7.28%,6%,755,12612,5.69%,94.31%,8073,728,2513,38,14,38,
0500000US40065,"Jackson County, Oklahoma",24808,12390,49.94%,50.06%,52.7,2079,8.38%,1087,953,192,4634,1612,2303,1254,13701,3557,5721,2565,2495,23.06%,10.34%,10%,5937,18848,23.93%,76.07%,14883,1614,382,320,77,57,
0500000US40067,"Jefferson County, Oklahoma",6084,3061,50.31%,49.69%,48.2,706,11.60%,191,97,26,1669,161,485,155,3436,640,1860,258,511,30.57%,4.24%,8%,584,4753,9.60%,90.40%,3993,27,258,30,5,15,
0500000US40069,"Johnston County, Oklahoma",11028,5554,50.36%,49.64%,48.9,783,7.10%,398,453,11,2569,658,1046,641,6389,1687,2967,1111,1057,26.90%,10.07%,10%,581,9691,5.27%,94.73%,6735,236,1582,52,5,57,
0500000US40071,"Kay County, Oklahoma",44074,22161,50.28%,49.72%,47.5,3780,8.58%,1368,1507,84,9459,3793,4115,1568,25972,5683,10827,5300,4199,24.57%,12.03%,10%,3652,40048,8.29%,91.71%,30728,856,4127,253,274,75,
0500000US40073,"Kingfisher County, Oklahoma",15811,7945,50.25%,49.75%,54.7,882,5.58%,568,378,4,4132,409,1635,730,9107,2365,4700,787,1639,29.73%,4.98%,10%,2755,12429,17.42%,82.58%,10985,170,417,45,0,26,
0500000US40075,"Kiowa County, Oklahoma",8816,4574,51.88%,48.12%,52.3,998,11.32%,289,213,16,2212,519,836,277,5235,1113,2501,732,852,28.37%,8.30%,10%,953,7556,10.81%,89.19%,6149,314,504,47,3,17,
0500000US40077,"Latimer County, Oklahoma",10239,5036,49.18%,50.82%,54.9,752,7.34%,418,337,27,2568,1002,713,363,6110,1076,2986,1339,740,29.16%,13.08%,7%,344,9100,3.36%,96.64%,5818,42,2216,67,5,16,
0500000US40079,"Le Flore County, Oklahoma",49999,25005,50.01%,49.99%,49.8,4100,8.20%,1886,1221,180,13519,3423,3687,1603,28448,5290,15405,4644,3867,30.81%,9.29%,8%,3573,44556,7.15%,92.85%,31920,841,6890,292,32,50,
0500000US40081,"Lincoln County, Oklahoma",34936,17558,50.26%,49.74%,53.6,1975,5.65%,1292,748,83,9938,1897,2490,1017,21139,3507,11230,2645,2573,32.14%,7.57%,7%,1137,32321,3.25%,96.75%,26146,592,2282,114,13,78,
0500000US40083,"Logan County, Oklahoma",47401,23843,50.30%,49.70%,51.3,2497,5.27%,1772,2370,307,9658,2863,6315,2883,28646,9198,11430,5233,6622,24.11%,11.04%,14%,4003,45552,8.44%,91.56%,36060,3201,1613,260,31,238,
0500000US40085,"Love County, Oklahoma",10128,5085,50.21%,49.79%,48.9,645,6.37%,317,294,21,2779,333,723,180,5655,903,3096,627,744,30.57%,6.19%,7%,1685,8461,16.64%,83.36%,6806,196,613,72,0,63,
0500000US40087,"McClain County, Oklahoma",39921,20098,50.34%,49.66%,61.8,1523,3.82%,1137,1255,154,8329,1944,4510,2269,23883,6779,9466,3199,4664,23.71%,8.01%,12%,3699,37963,9.27%,90.73%,30701,346,2653,209,36,100,
0500000US40089,"McCurtain County, Oklahoma",32913,16622,50.50%,49.50%,51.4,2624,7.97%,1163,830,54,9214,1447,2215,924,18023,3139,10377,2277,2269,31.53%,6.92%,7%,1894,28920,5.75%,94.25%,18159,2538,4290,124,460,40,
0500000US40091,"McIntosh County, Oklahoma",19677,9863,50.13%,49.88%,49,1747,8.88%,666,436,82,6019,1220,1401,495,12621,1896,6685,1656,1483,33.97%,8.42%,8%,491,18450,2.50%,97.50%,12644,547,3163,68,4,56,
0500000US40093,"Major County, Oklahoma",7654,3841,50.18%,49.82%,63.9,432,5.64%,218,157,0,2033,410,730,305,4655,1035,2251,567,730,29.41%,7.41%,10%,784,6998,10.24%,89.76%,6479,15,131,40,0,9,
0500000US40095,"Marshall County, Oklahoma",16688,8425,50.49%,49.52%,53.9,837,5.02%,492,435,65,4127,812,1285,464,9350,1749,4619,1247,1350,27.68%,7.47%,8%,2605,12707,15.61%,84.39%,9749,169,1413,44,4,85,
0500000US40097,"Mayes County, Oklahoma",41098,20611,50.15%,49.85%,54.4,3111,7.57%,1483,919,166,11540,2495,3054,1042,24655,4096,13023,3414,3220,31.69%,8.31%,8%,1375,37671,3.35%,96.65%,23516,180,8095,192,27,50,
0500000US40099,"Murray County, Oklahoma",13972,6868,49.16%,50.85%,53,859,6.15%,403,374,64,3854,481,1325,469,8224,1794,4257,855,1389,30.47%,6.12%,10%,926,12978,6.63%,93.37%,9446,153,1936,45,19,16,
0500000US40101,"Muskogee County, Oklahoma",68451,35055,51.21%,48.79%,46.3,5956,8.70%,2440,2180,282,15756,4645,6353,2670,39318,9023,18196,6825,6635,26.58%,9.97%,10%,4499,61840,6.57%,93.43%,34857,6545,11747,512,39,165,
0500000US40103,"Noble County, Oklahoma",11263,5700,50.61%,49.39%,57.5,848,7.53%,423,329,35,2919,657,1119,558,6957,1677,3342,986,1154,29.67%,8.75%,10%,420,10504,3.73%,96.27%,8414,145,953,47,0,30,
0500000US40105,"Nowata County, Oklahoma",10243,5156,50.34%,49.66%,54.6,546,5.33%,264,318,39,2984,787,696,270,6435,966,3248,1105,735,31.71%,10.79%,7%,241,9079,2.35%,97.65%,5812,104,1562,5,5,8,
0500000US40107,"Okfuskee County, Oklahoma",11987,5546,46.27%,53.73%,50.1,1320,11.01%,309,329,24,3254,664,635,306,6741,941,3563,993,659,29.72%,8.28%,5%,342,10968,2.85%,97.15%,6590,694,2559,32,0,33,
0500000US40109,"Oklahoma County, Oklahoma",792668,404760,51.06%,48.94%,45.5,53283,6.72%,24088,30518,6499,129243,38794,108447,63209,456645,171656,153331,69312,114946,19.34%,8.74%,15%,153498,642794,19.36%,80.64%,407986,117957,22034,27823,1168,3151,
0500000US40111,"Okmulgee County, Oklahoma",38553,19475,50.52%,49.49%,44.8,2405,6.24%,1449,1626,152,9329,3037,2551,1073,22395,3624,10778,4663,2703,27.96%,12.10%,7%,1708,34998,4.43%,95.57%,21599,2742,5947,160,22,82,
0500000US40113,"Osage County, Oklahoma",47074,23371,49.65%,50.35%,55.9,3077,6.54%,1599,1177,107,12218,3143,4629,1821,29859,6450,13817,4320,4736,29.35%,9.18%,10%,1872,43946,3.98%,96.02%,27443,4796,6405,128,19,96,
0500000US40115,"Ottawa County, Oklahoma",31283,15925,50.91%,49.09%,47.5,2437,7.79%,1242,1233,65,7144,2141,1982,1131,17496,3113,8386,3374,2047,26.81%,10.79%,7%,1708,28577,5.46%,94.54%,18850,287,5563,154,231,50,
0500000US40117,"Pawnee County, Oklahoma",16402,8165,49.78%,50.22%,55,890,5.43%,617,283,46,4830,953,1416,582,10137,1998,5447,1236,1462,33.21%,7.54%,9%,467,15086,2.85%,97.15%,11530,73,1927,49,0,42,
0500000US40119,"Payne County, Oklahoma",81912,40155,49.02%,50.98%,40.1,10689,13.05%,4926,13616,2474,12113,3353,9625,7140,40781,16765,17039,16969,12099,20.80%,20.72%,15%,5373,76273,6.56%,93.44%,58926,3123,3613,2662,53,296,
0500000US40121,"Pittsburg County, Oklahoma",43955,21577,49.09%,50.91%,52.6,3252,7.40%,1467,977,91,11252,2908,3735,1921,26813,5656,12719,3885,3826,28.94%,8.84%,9%,2266,41507,5.16%,94.84%,28388,1227,6388,280,35,62,
0500000US40123,"Pontotoc County, Oklahoma",38385,19705,51.34%,48.67%,46.8,1732,4.51%,1262,2231,294,7930,1574,4483,2681,22189,7164,9192,3805,4777,23.95%,9.91%,12%,2208,35857,5.75%,94.25%,22703,861,6842,372,13,98,
0500000US40125,"Pottawatomie County, Oklahoma",72511,37789,52.12%,47.89%,48.9,5073,7.00%,2120,3411,402,17132,4142,6039,3331,42769,9370,19252,7553,6441,26.55%,10.42%,9%,4288,68166,5.91%,94.09%,49158,2194,8693,495,39,171,
0500000US40127,"Pushmataha County, Oklahoma",11055,5664,51.24%,48.77%,56,863,7.81%,251,251,38,3473,528,629,525,6690,1154,3724,779,667,33.69%,7.05%,6%,376,10436,3.40%,96.60%,7382,66,1830,52,0,23,
0500000US40129,"Roger Mills County, Oklahoma",3635,1745,48.01%,51.99%,55.6,252,6.93%,70,83,42,848,160,282,150,2199,432,918,243,324,25.25%,6.69%,9%,256,3186,7.04%,92.96%,2860,5,106,5,1,1,
0500000US40131,"Rogers County, Oklahoma",92052,46287,50.28%,49.72%,58,3314,3.60%,3092,3110,572,20489,6751,10780,4419,57711,15199,23581,9861,11352,25.62%,10.71%,12%,5257,89983,5.71%,94.29%,62387,1103,12109,1676,39,286,
0500000US40133,"Seminole County, Oklahoma",24624,12582,51.10%,48.90%,48.3,2162,8.78%,824,881,61,5774,1331,1579,769,13789,2348,6598,2212,1640,26.79%,8.98%,7%,1176,22380,4.78%,95.22%,14109,920,4411,72,8,89,
0500000US40135,"Sequoyah County, Oklahoma",41687,21180,50.81%,49.19%,50.2,3132,7.51%,1421,1077,118,11294,2724,2749,1159,23340,3908,12715,3801,2867,30.50%,9.12%,7%,1726,37555,4.14%,95.86%,22497,585,8954,288,14,110,
0500000US40137,"Stephens County, Oklahoma",43401,22235,51.23%,48.77%,53.7,3201,7.38%,1761,797,95,13029,1375,3674,1879,26442,5553,14790,2172,3769,34.08%,5.00%,9%,3452,39396,7.95%,92.05%,32383,799,2034,244,13,143,
0500000US40139,"Texas County, Oklahoma",20633,9659,46.81%,53.19%,49.8,1582,7.67%,546,976,74,3397,409,2313,957,9336,3270,3943,1385,2387,19.11%,6.71%,12%,10823,10561,52.45%,47.55%,8263,975,162,448,0,68,
0500000US40141,"Tillman County, Oklahoma",7347,3643,49.59%,50.42%,46.1,792,10.78%,319,157,13,1763,282,554,268,3903,822,2082,439,567,28.34%,5.98%,8%,1923,5045,26.17%,73.83%,3982,474,191,26,0,25,
0500000US40143,"Tulsa County, Oklahoma",650291,332953,51.20%,48.80%,48,42208,6.49%,19742,22746,5747,109967,38943,91233,46092,385222,137325,129709,61689,96980,19.95%,9.49%,15%,100049,569230,15.39%,84.61%,371913,66182,36612,24846,1033,2355,
0500000US40145,"Wagoner County, Oklahoma",80264,40568,50.54%,49.46%,55.7,3378,4.21%,2203,2275,451,17486,5149,8971,4070,49605,13041,19689,7424,9422,24.53%,9.25%,12%,6137,74844,7.65%,92.35%,52734,2638,8073,1405,29,225,
0500000US40147,"Washington County, Oklahoma",51995,26723,51.40%,48.61%,51.3,2423,4.66%,1594,1570,253,12124,2752,6709,3493,32191,10202,13718,4322,6962,26.38%,8.31%,13%,3360,49095,6.46%,93.54%,35208,1322,5194,974,10,121,
0500000US40149,"Washita County, Oklahoma",11066,5557,50.22%,49.78%,56.2,532,4.81%,434,138,54,2959,430,865,661,6699,1526,3393,568,919,30.66%,5.13%,8%,980,9944,8.86%,91.14%,8818,77,303,22,0,17,
0500000US40151,"Woods County, Oklahoma",8914,4165,46.72%,53.28%,42.4,396,4.44%,305,848,113,1607,173,1098,529,4840,1627,1912,1021,1211,21.45%,11.45%,14%,613,8011,6.88%,93.12%,7025,228,240,74,1,15,
0500000US40153,"Woodward County, Oklahoma",20352,9452,46.44%,53.56%,50,1098,5.40%,711,403,145,5499,660,1860,805,12148,2665,6210,1063,2005,30.51%,5.22%,10%,3006,17464,14.77%,85.23%,15426,351,543,126,0,57,
0500000US41001,"Baker County, Oregon",16090,7827,48.65%,51.36%,57.3,747,4.64%,308,356,114,3532,1160,2118,886,10961,3004,3840,1516,2232,23.87%,9.42%,14%,809,15859,5.03%,94.97%,14664,70,172,64,15,98,
0500000US41003,"Benton County, Oregon",92168,45809,49.70%,50.30%,43.8,9736,10.56%,3500,13724,3188,7723,4758,16423,13505,54033,29928,11223,18482,19611,12.18%,20.05%,21%,8524,86660,9.25%,90.75%,72209,938,528,6375,276,538,
0500000US41005,"Clackamas County, Oregon",415084,210197,50.64%,49.36%,55,14381,3.46%,10923,12765,3212,62894,28456,72364,39534,275962,111898,73817,41221,75576,17.78%,9.93%,18%,40342,381059,9.72%,90.28%,325361,4336,2249,20459,1056,2158,
0500000US41007,"Clatsop County, Oregon",39656,20015,50.47%,49.53%,47.5,2127,5.36%,1152,1218,131,7957,3169,4475,2469,26756,6944,9109,4387,4606,22.97%,11.06%,12%,3848,37224,9.70%,90.30%,33526,224,344,552,91,231,
0500000US41009,"Columbia County, Oregon",52117,26036,49.96%,50.04%,51.8,2097,4.02%,1755,1198,152,12429,3951,4519,2246,34053,6765,14184,5149,4671,27.22%,9.88%,9%,3070,49519,5.89%,94.11%,44228,300,618,561,117,267,
0500000US41011,"Coos County, Oregon",64175,32519,50.67%,49.33%,49.2,5052,7.87%,1511,1410,279,14750,4301,5995,3579,43252,9574,16261,5711,6274,25.34%,8.90%,10%,4292,60637,6.69%,93.31%,53538,259,1320,728,120,316,
0500000US41013,"Crook County, Oregon",23733,11890,50.10%,49.90%,55.6,852,3.59%,625,481,7,5780,1575,2382,966,15869,3348,6405,2056,2389,26.99%,8.66%,10%,1803,22935,7.60%,92.40%,20874,78,262,114,23,102,
0500000US41015,"Curry County, Oregon",22889,11604,50.70%,49.30%,55.5,857,3.74%,633,171,13,5269,1884,2551,1844,17232,4395,5902,2055,2564,25.79%,8.98%,11%,1674,21772,7.31%,92.69%,19428,77,461,214,25,125,
0500000US41017,"Deschutes County, Oregon",191749,96894,50.53%,49.47%,55.6,7746,4.04%,3648,5667,1666,30264,14009,32008,20105,131473,52113,33912,19676,33674,17.69%,10.26%,18%,17237,181016,8.99%,91.01%,164595,786,1139,2421,258,1028,
0500000US41019,"Douglas County, Oregon",110015,55575,50.52%,49.48%,53.6,5960,5.42%,3626,2337,289,26483,8528,9794,5235,73697,15029,30109,10865,10083,27.37%,9.88%,9%,6654,104547,6.05%,93.95%,93525,383,1694,1185,151,532,
0500000US41021,"Gilliam County, Oregon",1896,975,51.42%,48.58%,46,116,6.12%,31,7,0,482,124,257,59,1359,316,513,131,257,27.06%,6.91%,14%,107,1888,5.64%,94.36%,1747,3,29,6,9,3,
0500000US41023,"Grant County, Oregon",7174,3530,49.21%,50.80%,58,455,6.34%,174,80,29,1951,475,754,404,4969,1158,2125,555,783,29.62%,7.74%,11%,283,6950,3.94%,96.06%,6430,10,58,23,10,19,
0500000US41025,"Harney County, Oregon",7310,3630,49.66%,50.34%,60.6,272,3.72%,258,148,1,1904,535,513,367,4891,880,2162,683,514,29.58%,9.34%,7%,394,7101,5.39%,94.61%,6435,5,219,36,0,21,
0500000US41027,"Hood River County, Oregon",23270,11751,50.50%,49.50%,56.7,292,1.25%,657,543,11,3295,1306,2922,2599,13116,5521,3952,1849,2933,16.98%,7.95%,13%,7148,16829,30.72%,69.28%,14935,47,149,381,33,119,
0500000US41029,"Jackson County, Oregon",218781,111921,51.16%,48.84%,52,12127,5.54%,5788,7728,714,39607,14096,27661,17640,142121,45301,45395,21824,28375,20.75%,9.98%,13%,30399,192860,13.89%,86.11%,170232,1574,1775,3293,808,1496,
0500000US41031,"Jefferson County, Oregon",24048,11588,48.19%,51.81%,45.5,1607,6.68%,1035,592,0,5032,1398,2380,1175,14645,3555,6067,1990,2380,25.23%,8.28%,10%,5002,19500,20.80%,79.20%,15005,134,2981,131,18,66,
0500000US41033,"Josephine County, Oregon",87097,44582,51.19%,48.81%,55.2,6659,7.65%,1697,2256,209,19511,6271,7642,4085,58766,11727,21208,8527,7851,24.35%,9.79%,9%,7037,81053,8.08%,91.92%,72730,368,883,870,123,493,
0500000US41035,"Klamath County, Oregon",67606,33876,50.11%,49.89%,50.1,5610,8.30%,1844,2663,208,15013,4794,6460,3623,41659,10083,16857,7457,6668,24.93%,11.03%,10%,8772,60641,12.98%,87.02%,51919,497,2493,754,104,396,
0500000US41037,"Lake County, Oregon",7896,3706,46.94%,53.07%,53.1,617,7.81%,215,160,0,2040,486,728,435,5259,1163,2255,646,728,28.56%,8.18%,9%,802,7358,10.16%,89.84%,6508,49,114,52,10,42,
0500000US41039,"Lane County, Oregon",377749,191837,50.78%,49.22%,44.6,30018,7.95%,13663,24819,4564,60148,25154,49504,33643,241162,83147,73811,49973,54068,19.54%,13.23%,14%,37780,345191,10.00%,90.00%,298507,4352,3355,9404,947,2377,
0500000US41041,"Lincoln County, Oregon",49336,25625,51.94%,48.06%,49.9,3564,7.22%,1183,973,162,9493,3376,6569,4008,35187,10577,10676,4349,6731,21.64%,8.82%,14%,4851,45544,9.83%,90.17%,39498,189,1521,646,93,276,
0500000US41043,"Linn County, Oregon",127216,64476,50.68%,49.32%,51.8,6513,5.12%,3576,4211,611,25915,8657,11406,5886,79629,17292,29491,12868,12017,23.18%,10.12%,9%,12571,116039,9.88%,90.12%,104118,623,1283,1434,280,658,
0500000US41045,"Malheur County, Oregon",30632,13852,45.22%,54.78%,42.2,1934,6.31%,991,1103,55,6076,1989,2021,971,16275,2992,7067,3092,2076,23.07%,10.09%,7%,10320,21251,33.69%,66.31%,18975,447,295,385,40,115,
0500000US41047,"Marion County, Oregon",343742,172529,50.19%,49.81%,48.3,18637,5.42%,11704,13149,2110,58891,21099,35992,18881,193908,54873,70595,34248,38102,20.54%,9.96%,11%,95740,250180,27.85%,72.15%,213650,3787,3124,7270,3669,1701,
0500000US41049,"Morrow County, Oregon",11425,5680,49.72%,50.28%,57.5,587,5.14%,391,341,114,2503,579,473,182,5636,655,2894,920,587,25.33%,8.05%,5%,4988,7198,43.66%,56.34%,6600,37,82,29,5,44,
0500000US41051,"Multnomah County, Oregon",809869,408786,50.48%,49.52%,42.5,50107,6.19%,16940,29790,10233,102213,44310,167571,109184,547168,276755,119153,74100,177804,14.71%,9.15%,22%,103753,711675,12.81%,87.19%,535623,43793,5455,61280,5251,4885,
0500000US41053,"Polk County, Oregon",84730,43303,51.11%,48.89%,51.7,4393,5.18%,3341,5299,1233,13104,5329,9923,6693,49858,16616,16445,10628,11156,19.41%,12.54%,13%,12730,74703,15.02%,84.98%,64719,682,1579,1702,344,412,
0500000US41055,"Sherman County, Oregon",1686,780,46.26%,53.74%,48.6,74,4.39%,30,65,4,352,174,152,94,1100,246,382,239,156,22.66%,14.18%,9%,119,1751,7.06%,92.94%,1610,0,19,7,0,3,
0500000US41057,"Tillamook County, Oregon",26782,13362,49.89%,50.11%,53.3,1408,5.26%,602,611,170,5743,2129,2635,1661,18141,4296,6345,2740,2805,23.69%,10.23%,10%,2946,24444,11.00%,89.00%,22000,76,239,280,85,141,
0500000US41059,"Umatilla County, Oregon",77319,37122,48.01%,51.99%,48.4,3986,5.16%,2317,2704,331,14737,5127,5642,3262,42226,8904,17054,7831,5973,22.06%,10.13%,8%,22622,57453,29.26%,70.74%,49753,652,2571,685,130,295,
0500000US41061,"Union County, Oregon",26502,13425,50.66%,49.34%,50.7,1456,5.49%,1036,1293,320,5820,1620,2962,1313,16423,4275,6856,2913,3282,25.87%,10.99%,12%,1347,24849,5.08%,94.92%,22075,145,219,216,488,129,
0500000US41063,"Wallowa County, Oregon",7065,3603,51.00%,49.00%,58.6,215,3.04%,46,107,30,1641,455,962,499,5125,1461,1687,562,992,23.88%,7.95%,14%,257,7134,3.64%,96.36%,6598,9,50,31,4,54,
0500000US41065,"Wasco County, Oregon",26274,13111,49.90%,50.10%,49.3,902,3.43%,727,794,60,5244,1891,2332,1430,16127,3762,5971,2685,2392,22.73%,10.22%,9%,5017,21653,19.09%,80.91%,18703,115,983,248,185,110,
0500000US41067,"Washington County, Oregon",595761,300625,50.46%,49.54%,52.9,23055,3.87%,15261,20167,6819,71740,36139,114445,70237,380730,184682,87001,56306,121264,14.60%,9.45%,20%,107642,492730,18.07%,81.93%,365232,12763,2416,68430,3240,3096,
0500000US41069,"Wheeler County, Oregon",1417,723,51.02%,48.98%,63.3,40,2.82%,25,25,0,362,147,139,70,1031,209,387,172,139,27.31%,12.14%,10%,84,1367,5.93%,94.07%,1256,1,17,8,0,1,
0500000US41071,"Yamhill County, Oregon",106087,52955,49.92%,50.08%,52.1,5255,4.95%,3406,5639,790,17443,6657,12686,6914,64246,19600,20849,12296,13476,19.65%,11.59%,13%,17793,89929,16.77%,83.23%,79352,849,1346,1523,189,615,
0500000US42001,"Adams County, Pennsylvania",102627,52155,50.82%,49.18%,56.7,3608,3.52%,3852,4325,642,28594,6449,9265,7078,64543,16343,32446,10774,9907,31.62%,10.50%,10%,7790,96062,7.59%,92.41%,89945,1473,147,952,33,333,
0500000US42003,"Allegheny County, Pennsylvania",1218380,629258,51.65%,48.35%,45.8,64643,5.31%,31753,42923,22962,233079,87227,218237,157201,837779,375438,264832,130150,241199,21.74%,10.68%,20%,34325,1216253,2.82%,97.18%,938252,161554,1305,58318,304,6064,
0500000US42005,"Armstrong County, Pennsylvania",65356,32929,50.38%,49.62%,56.3,2733,4.18%,2069,1211,526,23787,4852,5993,2766,44395,8759,25856,6063,6519,39.56%,9.28%,10%,490,65068,0.75%,99.25%,62320,438,57,147,14,120,
0500000US42007,"Beaver County, Pennsylvania",164781,84969,51.57%,48.44%,51.2,7119,4.32%,4232,4920,1434,44063,14747,20960,9930,113378,30890,48295,19667,22394,29.31%,11.94%,14%,3611,164604,2.19%,97.81%,143881,11069,195,1022,53,613,
0500000US42009,"Bedford County, Pennsylvania",48154,24405,50.68%,49.32%,56.2,2016,4.19%,1695,1005,252,17468,3203,3317,2281,31236,5598,19163,4208,3569,39.80%,8.74%,7%,519,47058,1.08%,98.92%,45381,181,66,153,0,50,
0500000US42011,"Berks County, Pennsylvania",419062,212749,50.77%,49.23%,48.3,21273,5.08%,15565,14931,4173,103554,25149,46858,27090,248866,73948,119119,40080,51031,28.43%,9.56%,12%,99550,329299,23.76%,76.24%,291258,18087,450,6225,61,1551,
0500000US42013,"Blair County, Pennsylvania",122495,62540,51.06%,48.95%,49.2,6699,5.47%,3453,3382,1238,39096,7950,13365,6281,80933,19646,42549,11332,14603,34.74%,9.25%,12%,1708,121114,1.39%,98.61%,113016,2463,134,868,12,367,
0500000US42015,"Bradford County, Pennsylvania",60721,30674,50.52%,49.48%,53.3,3190,5.25%,2135,1217,370,20288,3737,5056,2971,38607,8027,22423,4954,5426,36.93%,8.16%,9%,873,59094,1.44%,98.56%,55717,394,117,460,13,133,
0500000US42017,"Bucks County, Pennsylvania",627668,319497,50.90%,49.10%,56,16054,2.56%,17216,16964,9800,125978,35706,113022,77020,424327,190042,143194,52670,122822,22.81%,8.39%,20%,39770,606768,6.34%,93.66%,521575,25277,531,35053,143,2512,
0500000US42019,"Butler County, Pennsylvania",187798,94562,50.35%,49.65%,55.8,6655,3.54%,5779,6711,2155,42635,13862,32382,17965,128091,50347,48414,20573,34537,25.78%,10.95%,18%,3665,190098,1.95%,98.05%,178081,2174,154,2792,36,577,
0500000US42021,"Cambria County, Pennsylvania",131611,66894,50.83%,49.17%,49,7597,5.77%,4142,5673,1034,41875,10108,13387,7371,86929,20758,46017,15781,14421,34.96%,11.99%,11%,2465,131007,1.87%,98.13%,119380,5665,96,764,35,320,
0500000US42023,"Cameron County, Pennsylvania",4512,2301,51.00%,49.00%,48.2,215,4.77%,183,51,2,1733,280,304,73,3193,377,1916,331,306,42.46%,7.34%,7%,86,4461,1.91%,98.09%,4271,12,8,29,0,12,
0500000US42025,"Carbon County, Pennsylvania",63964,32304,50.50%,49.50%,49.4,3519,5.50%,1870,1179,442,21140,5276,5477,3025,42576,8502,23010,6455,5919,35.97%,10.09%,9%,3642,61107,5.69%,94.31%,57439,1070,95,327,14,216,
0500000US42027,"Centre County, Pennsylvania",162264,76955,47.43%,52.57%,41.7,17890,11.03%,11467,21827,3564,27967,8021,23529,22142,94282,45671,39434,29848,27093,24.30%,18.39%,17%,5651,152521,3.48%,96.52%,129668,5306,120,11373,39,596,
0500000US42029,"Chester County, Pennsylvania",521980,264754,50.72%,49.28%,56,15971,3.06%,14627,17337,9724,72918,23131,113574,79565,335924,193139,87545,40468,123298,16.77%,7.75%,24%,43542,490871,8.34%,91.66%,405476,28391,532,35143,119,2249,
0500000US42031,"Clarion County, Pennsylvania",38633,19624,50.80%,49.20%,51.2,2765,7.16%,1446,2386,490,12188,2479,3616,2475,24002,6091,13634,4865,4106,35.29%,12.59%,11%,387,36854,1.00%,99.00%,35023,521,39,175,15,111,
0500000US42033,"Clearfield County, Pennsylvania",79466,37597,47.31%,52.69%,49.2,4067,5.12%,3105,1470,526,28665,5772,6438,3514,52254,9952,31770,7242,6964,39.98%,9.11%,9%,2637,77925,3.32%,96.68%,73338,1760,78,450,0,146,
0500000US42035,"Clinton County, Pennsylvania",38549,19401,50.33%,49.67%,49.1,1996,5.18%,1988,2276,469,12024,2214,3133,1823,22746,4956,14012,4490,3602,36.35%,11.65%,9%,662,36788,1.72%,98.28%,34933,416,51,211,7,70,
0500000US42037,"Columbia County, Pennsylvania",65390,33942,51.91%,48.09%,44.7,4154,6.35%,2789,5554,1019,18725,3902,6494,4160,39779,10654,21514,9456,7513,32.90%,14.46%,11%,2140,62587,3.27%,96.73%,58831,867,71,748,17,159,
0500000US42039,"Crawford County, Pennsylvania",85074,43631,51.29%,48.71%,52.4,3632,4.27%,2932,2988,408,28222,4741,7577,4613,53595,12190,31154,7729,7985,36.62%,9.09%,9%,1241,82697,1.46%,98.54%,77347,1496,109,365,26,229,
0500000US42041,"Cumberland County, Pennsylvania",251487,126918,50.47%,49.53%,51.9,8049,3.20%,6430,12397,2530,55989,13546,40941,25150,164027,66091,62419,25943,43471,24.82%,10.32%,17%,11975,247494,4.76%,95.24%,211990,10581,318,13836,113,1074,
0500000US42043,"Dauphin County, Pennsylvania",277071,142577,51.46%,48.54%,48.4,16131,5.82%,8473,7652,3024,62464,18399,39594,22558,175088,62152,70937,26051,42618,25.60%,9.40%,15%,31251,255150,11.28%,88.72%,175175,48404,396,17183,88,1465,
0500000US42045,"Delaware County, Pennsylvania",565328,293397,51.90%,48.10%,46.1,24448,4.32%,17583,24614,7733,113018,29611,87354,64838,359044,152192,130601,54225,95087,23.10%,9.59%,17%,26772,550058,4.74%,95.26%,363249,127055,676,36317,133,2596,
0500000US42047,"Elk County, Pennsylvania",30077,14818,49.27%,50.73%,52.9,1043,3.47%,934,602,214,10802,2597,2871,1375,20593,4246,11736,3199,3085,39.02%,10.64%,10%,294,30696,0.98%,99.02%,29466,74,16,113,12,46,
0500000US42049,"Erie County, Pennsylvania",272046,137723,50.63%,49.38%,45.7,17385,6.39%,9180,11777,3070,70762,17847,34469,19337,171442,53806,79942,29624,37539,29.39%,10.89%,14%,12030,258846,4.42%,95.58%,219180,19821,343,6358,58,1046,
0500000US42051,"Fayette County, Pennsylvania",130329,65701,50.41%,49.59%,48.2,8849,6.79%,4420,3021,1171,46075,8329,11373,5544,85016,16917,50495,11350,12544,38.74%,8.71%,10%,1578,127226,1.21%,98.79%,115322,5703,166,376,160,313,
0500000US42053,"Forest County, Pennsylvania",7190,2190,30.46%,69.54%,33.2,243,3.38%,331,55,18,3411,247,391,209,5256,600,3742,302,409,52.04%,4.20%,6%,323,6650,4.49%,95.51%,5278,1235,8,17,0,4,
0500000US42055,"Franklin County, Pennsylvania",154954,78855,50.89%,49.11%,55.9,5795,3.74%,4637,3675,1148,47155,9198,14682,9448,96342,24130,51792,12873,15830,33.42%,8.31%,10%,10764,145168,6.95%,93.05%,132566,4998,242,1408,40,501,
0500000US42057,"Fulton County, Pennsylvania",14492,7172,49.49%,50.51%,57.7,529,3.65%,442,406,66,5341,993,942,636,9421,1578,5783,1399,1008,39.90%,9.65%,7%,146,14410,1.01%,98.99%,13726,124,25,41,3,17,
0500000US42059,"Greene County, Pennsylvania",36484,17444,47.81%,52.19%,49.3,2203,6.04%,1080,1544,335,11768,2315,3065,1559,22842,4624,12848,3859,3400,35.22%,10.58%,9%,510,35444,1.40%,98.60%,32898,1062,69,120,6,63,
0500000US42061,"Huntingdon County, Pennsylvania",45145,21119,46.78%,53.22%,51.3,1659,3.67%,1791,1748,320,16044,2725,3904,1929,29384,5833,17835,4473,4224,39.51%,9.91%,9%,852,43240,1.89%,98.11%,39420,2267,49,210,9,100,
0500000US42063,"Indiana County, Pennsylvania",84463,42146,49.90%,50.10%,47.8,5132,6.08%,3775,7198,1021,23106,5142,7881,6039,50543,13920,26881,12340,8902,31.83%,14.61%,11%,1476,81770,1.75%,98.25%,75718,2409,116,816,7,148,
0500000US42065,"Jefferson County, Pennsylvania",43570,21862,50.18%,49.82%,54.5,2621,6.02%,1559,738,249,15869,3227,3355,1663,28133,5018,17428,3965,3604,40.00%,9.10%,8%,397,44095,0.91%,99.09%,42317,125,45,100,8,92,
0500000US42067,"Juniata County, Pennsylvania",24657,12410,50.33%,49.67%,54.7,700,2.84%,792,444,187,8448,1213,1733,902,14417,2635,9240,1657,1920,37.47%,6.72%,8%,908,22601,3.68%,96.32%,21830,115,19,69,4,48,
0500000US42069,"Lackawanna County, Pennsylvania",210162,108172,51.47%,48.53%,46.1,12769,6.08%,4808,9261,2524,54655,14073,26540,16135,136098,42675,59463,23334,29064,28.29%,11.10%,14%,18267,197629,8.69%,91.31%,175246,7415,276,6762,28,828,
0500000US42071,"Lancaster County, Pennsylvania",543050,277093,51.03%,48.98%,55.8,20067,3.70%,17725,14999,5760,127761,28295,67413,37349,314204,104762,145486,43294,73173,26.79%,7.97%,13%,61171,491813,11.26%,88.74%,440613,19536,522,13939,110,1922,
0500000US42073,"Lawrence County, Pennsylvania",86148,44503,51.66%,48.34%,50.2,4636,5.38%,2748,2974,492,26934,5791,9536,4295,56585,13831,29682,8765,10028,34.45%,10.17%,12%,1655,84415,1.92%,98.08%,75811,3546,75,321,4,251,
0500000US42075,"Lebanon County, Pennsylvania",140410,71466,50.90%,49.10%,52.2,5717,4.07%,5182,3927,786,42564,7206,13317,7143,84576,20460,47746,11133,14103,34.00%,7.93%,10%,20348,122909,14.49%,85.51%,114004,2555,119,2192,39,460,
0500000US42077,"Lehigh County, Pennsylvania",367338,187689,51.09%,48.91%,48.1,18362,5.00%,11095,14664,3476,81963,23499,47407,29862,224401,77269,93058,38163,50883,25.33%,10.39%,14%,96981,277576,26.40%,73.60%,227994,22950,337,13725,91,1779,
0500000US42079,"Luzerne County, Pennsylvania",317547,160563,50.56%,49.44%,45.3,20705,6.52%,9153,11930,2487,87923,24364,33124,20404,204863,53528,97076,36294,35611,30.57%,11.43%,11%,46898,278696,14.77%,85.23%,250304,14031,295,3960,65,985,
0500000US42081,"Lycoming County, Pennsylvania",114014,58186,51.03%,48.97%,49.9,6674,5.85%,3941,4568,580,30375,9582,12546,6340,72807,18886,34316,14150,13126,30.10%,12.41%,12%,2374,111814,2.08%,97.92%,99687,5672,191,923,27,383,
0500000US42083,"McKean County, Pennsylvania",41021,19803,48.28%,51.73%,50.1,2645,6.45%,1504,1381,339,13680,2987,3552,1986,26815,5538,15184,4368,3891,37.02%,10.65%,9%,642,39790,1.57%,98.43%,36991,849,102,193,2,82,
0500000US42085,"Mercer County, Pennsylvania",110519,56013,50.68%,49.32%,49.5,5349,4.84%,4478,4380,621,32772,7670,11376,6429,70435,17805,37250,12050,11997,33.70%,10.90%,11%,1609,109043,1.46%,98.54%,96998,6289,116,683,14,342,
0500000US42087,"Mifflin County, Pennsylvania",46179,23527,50.95%,49.05%,56.5,1425,3.09%,1507,765,182,16207,2414,2758,1526,27508,4284,17714,3179,2940,38.36%,6.88%,6%,979,45164,2.12%,97.88%,43343,350,51,160,0,78,
0500000US42089,"Monroe County, Pennsylvania",168824,85174,50.45%,49.55%,48.5,8345,4.94%,6996,6380,1723,40912,10091,18474,11947,105544,30421,47908,16471,20197,28.38%,9.76%,12%,28558,139769,16.92%,83.08%,104716,22823,289,3947,56,1407,
0500000US42091,"Montgomery County, Pennsylvania",827180,424762,51.35%,48.65%,54.6,21720,2.63%,19470,25451,13866,135488,42615,164225,125003,549739,289228,154958,68066,178091,18.73%,8.23%,22%,54512,802041,6.59%,93.41%,618244,79510,763,67761,168,3863,
0500000US42093,"Montour County, Pennsylvania",18178,9463,52.06%,47.94%,51.5,756,4.16%,544,241,152,5219,917,2159,2211,12072,4370,5763,1158,2311,31.70%,6.37%,13%,487,17649,2.68%,97.32%,16105,320,27,668,0,22,
0500000US42095,"Northampton County, Pennsylvania",304233,154576,50.81%,49.19%,49.9,10785,3.54%,9011,14985,3411,72965,19428,42108,25916,194968,68024,81976,34413,45519,26.95%,11.31%,15%,44597,268354,14.66%,85.34%,228373,17429,251,9892,75,1647,
0500000US42097,"Northumberland County, Pennsylvania",91234,45179,49.52%,50.48%,51,5369,5.88%,2970,2091,361,32946,5380,8262,3657,59476,11919,35916,7471,8623,39.37%,8.19%,9%,4151,87496,4.55%,95.45%,81689,2392,110,444,24,199,
0500000US42099,"Perry County, Pennsylvania",46133,22752,49.32%,50.68%,59.1,1953,4.23%,1383,965,172,14917,3105,4210,1874,29060,6084,16300,4070,4382,35.33%,8.82%,9%,912,44930,1.98%,98.02%,42838,289,50,139,3,139,
0500000US42101,"Philadelphia County, Pennsylvania",1581531,832685,52.65%,47.35%,30.8,166036,10.50%,50653,62629,23308,344083,64875,194201,143829,927939,338030,394736,127504,217509,24.96%,8.06%,14%,238277,1365520,15.07%,84.93%,550828,613835,2596,132408,579,11419,
0500000US42103,"Pike County, Pennsylvania",55660,27432,49.29%,50.72%,55.5,2159,3.88%,1747,1397,405,14067,4119,6635,4625,38464,11260,15814,5516,7040,28.41%,9.91%,13%,6719,51816,12.07%,87.93%,45375,3027,121,841,14,234,
0500000US42105,"Potter County, Pennsylvania",16685,8328,49.91%,50.09%,53.5,817,4.90%,523,407,78,5593,1147,1191,661,10779,1852,6116,1554,1269,36.66%,9.31%,8%,247,16149,1.48%,98.52%,15494,43,25,69,0,52,
0500000US42107,"Schuylkill County, Pennsylvania",141935,69189,48.75%,51.25%,47.4,6874,4.84%,4347,2960,632,47670,11225,12030,5586,92904,17616,52017,14185,12662,36.65%,9.99%,9%,8064,134985,5.68%,94.32%,126192,4115,155,748,13,287,
0500000US42109,"Snyder County, Pennsylvania",40452,20257,50.08%,49.92%,53.7,1384,3.42%,1713,2281,162,12092,2324,3576,2134,23492,5710,13805,4605,3738,34.13%,11.38%,9%,977,38759,2.42%,97.58%,36992,504,32,296,11,58,
0500000US42111,"Somerset County, Pennsylvania",73844,35299,47.80%,52.20%,53.4,2799,3.79%,2360,1333,378,26970,5217,6052,3201,49150,9253,29330,6550,6430,39.72%,8.87%,9%,1037,73092,1.40%,98.60%,69044,1863,50,194,7,126,
0500000US42113,"Sullivan County, Pennsylvania",6038,2877,47.65%,52.35%,50.9,280,4.64%,153,130,27,2305,549,567,327,4460,894,2458,679,594,40.71%,11.25%,10%,105,5735,1.74%,98.26%,5406,77,9,17,0,29,
0500000US42115,"Susquehanna County, Pennsylvania",40604,20282,49.95%,50.05%,53.1,2253,5.55%,1282,850,221,13852,2659,3767,2022,27318,5789,15134,3509,3988,37.27%,8.64%,10%,847,37587,2.09%,97.91%,35799,138,59,135,0,98,
0500000US42117,"Tioga County, Pennsylvania",40759,20476,50.24%,49.76%,53.6,1942,4.76%,1510,1173,301,13043,2703,3540,2224,26693,5764,14553,3876,3841,35.70%,9.51%,9%,640,40405,1.57%,98.43%,38257,321,73,189,7,99,
0500000US42119,"Union County, Pennsylvania",44831,20223,45.11%,54.89%,46.6,1422,3.17%,1834,3331,400,12518,2568,3925,3846,26824,7771,14352,5899,4325,32.01%,13.16%,10%,2000,40681,4.46%,95.54%,36050,2459,82,814,8,112,
0500000US42121,"Venango County, Pennsylvania",51355,25976,50.58%,49.42%,53.6,2542,4.95%,1846,839,239,18195,3446,4948,2358,34486,7306,20041,4285,5187,39.02%,8.34%,10%,577,49877,1.12%,98.88%,47117,434,68,172,10,96,
0500000US42123,"Warren County, Pennsylvania",39466,19714,49.95%,50.05%,55.1,1753,4.44%,1393,673,201,13158,3245,3730,1917,27105,5647,14551,3918,3931,36.87%,9.93%,10%,415,38172,1.05%,98.95%,36310,144,71,154,5,57,
0500000US42125,"Washington County, Pennsylvania",207081,105405,50.90%,49.10%,52.6,7837,3.78%,6049,6966,2080,55803,14457,29871,15905,139662,45776,61852,21423,31951,29.87%,10.35%,15%,4021,205328,1.94%,98.06%,186900,6861,230,1998,63,620,
0500000US42127,"Wayne County, Pennsylvania",51268,24051,46.91%,53.09%,51.7,1889,3.68%,1487,1051,295,16644,3533,4892,3223,35356,8115,18131,4584,5187,35.37%,8.94%,10%,2347,48808,4.58%,95.42%,44821,1647,73,418,0,165,
0500000US42129,"Westmoreland County, Pennsylvania",350722,179204,51.10%,48.90%,54.5,13474,3.84%,8861,11356,3358,93365,30417,50151,28614,246747,78765,102226,41773,53509,29.15%,11.91%,15%,5230,349433,1.49%,98.51%,323114,8985,295,3301,36,953,
0500000US42131,"Wyoming County, Pennsylvania",27078,13492,49.83%,50.17%,51.4,1065,3.93%,913,913,214,9005,1767,2605,1425,18112,4030,9918,2680,2819,36.63%,9.90%,10%,581,25488,2.15%,97.85%,24142,214,32,115,3,40,
0500000US42133,"York County, Pennsylvania",447628,226459,50.59%,49.41%,52.3,17272,3.86%,15090,12489,3286,122486,29677,51084,27701,282406,78785,137576,42166,54370,30.73%,9.42%,12%,39360,417078,8.79%,91.21%,365353,25768,640,6557,118,1768,
0500000US44001,"Bristol County, Rhode Island",48645,25274,51.96%,48.04%,50.8,1321,2.72%,1567,2745,653,6911,2204,8945,7956,31185,16901,8478,4949,9598,17.43%,10.17%,20%,1943,48850,3.99%,96.01%,44671,732,85,1279,1,169,
0500000US44003,"Kent County, Rhode Island",164122,84620,51.56%,48.44%,50.3,6230,3.80%,3531,5179,1738,35075,13206,24529,15258,112539,39787,38606,18385,26267,23.52%,11.20%,16%,9665,160698,5.89%,94.11%,144761,2889,364,4830,32,767,
0500000US44005,"Newport County, Rhode Island",82731,41892,50.64%,49.36%,50,3024,3.66%,2380,2886,1971,12366,4377,18299,12109,57929,30408,14746,7263,20270,17.82%,8.78%,25%,5592,80051,6.76%,93.24%,70914,2645,265,1543,49,599,
0500000US44007,"Providence County, Rhode Island",636161,326326,51.30%,48.70%,40.6,34508,5.42%,22596,31526,7719,133806,33845,81697,50851,377083,132548,156402,65371,89416,24.59%,10.28%,14%,160323,500418,25.20%,74.80%,378615,47652,1882,28110,190,9367,
0500000US44009,"Washington County, Rhode Island",126139,65162,51.66%,48.34%,50.9,5980,4.74%,5401,9165,2306,19200,7262,22511,17489,82376,40000,24601,16427,24817,19.50%,13.02%,20%,4578,125261,3.63%,96.37%,115089,1468,917,2605,48,490,
0500000US45001,"Abbeville County, South Carolina",24582,12736,51.81%,48.19%,48.4,1821,7.41%,744,1219,72,6110,2240,2241,916,14289,3157,6854,3459,2313,27.88%,14.07%,9%,423,23872,1.72%,98.28%,16744,6184,44,71,7,70,
0500000US45003,"Aiken County, South Carolina",169947,88203,51.90%,48.10%,50.1,9686,5.70%,4329,6131,1203,38222,10256,20941,12307,106725,33248,42551,16387,22144,25.04%,9.64%,13%,11526,157282,6.78%,93.22%,107918,39465,530,1773,96,669,
0500000US45005,"Allendale County, South Carolina",8789,4022,45.76%,54.24%,32,791,9.00%,452,153,2,2462,351,380,263,4749,643,2914,504,382,33.16%,5.73%,4%,194,7845,2.21%,97.79%,1985,5646,45,17,1,13,
0500000US45007,"Anderson County, South Carolina",200183,103756,51.83%,48.17%,51.5,11789,5.89%,6048,6972,1169,41633,16043,20909,12352,118148,33261,47681,23015,22078,23.82%,11.50%,11%,9574,194144,4.78%,95.22%,152396,30214,425,2404,46,698,
0500000US45009,"Bamberg County, South Carolina",14236,7174,50.39%,49.61%,42.3,1623,11.40%,326,1398,22,3019,1214,946,766,7498,1712,3345,2612,968,23.50%,18.35%,7%,141,13170,0.99%,99.01%,5010,7749,25,66,0,36,
0500000US45011,"Barnwell County, South Carolina",21170,10978,51.86%,48.14%,40.8,2614,12.35%,651,641,238,4929,1753,1153,917,11628,2070,5580,2394,1391,26.36%,11.31%,7%,520,20069,2.46%,97.54%,10352,8785,61,161,14,58,
0500000US45013,"Beaufort County, South Carolina",189732,96699,50.97%,49.03%,55.7,7221,3.81%,7355,6522,903,30097,12251,33636,24126,128391,57762,37452,18773,34539,19.74%,9.89%,18%,23411,163706,12.34%,87.66%,126704,27545,354,2381,119,675,
0500000US45015,"Berkeley County, South Carolina",222103,111753,50.32%,49.68%,49.5,12375,5.57%,7468,8309,2587,44735,15118,24977,12694,132170,37671,52203,23427,27564,23.50%,10.55%,12%,20328,209533,9.15%,90.85%,137840,51784,1035,5353,173,1720,
0500000US45017,"Calhoun County, South Carolina",14608,7549,51.68%,48.32%,52.8,815,5.58%,378,553,63,3968,1131,1467,559,9305,2026,4346,1684,1530,29.75%,11.53%,10%,487,13632,3.33%,96.67%,7783,5361,62,27,6,30,
0500000US45019,"Charleston County, South Carolina",407543,210338,51.61%,48.39%,44.6,25089,6.16%,8485,16896,6895,63194,24968,83470,48605,269533,132075,71679,41864,90365,17.59%,10.27%,22%,29280,378955,7.18%,92.82%,263560,91746,857,7461,319,1533,
0500000US45021,"Cherokee County, South Carolina",57110,29461,51.59%,48.41%,43.5,5569,9.75%,1694,2013,329,14049,3877,3367,2209,31587,5576,15743,5890,3696,27.57%,10.31%,6%,2777,53439,4.86%,95.14%,39576,11292,161,341,14,195,
0500000US45023,"Chester County, South Carolina",32260,16619,51.52%,48.48%,47.4,2316,7.18%,1006,1119,80,9179,2166,2121,966,18847,3087,10185,3285,2201,31.57%,10.18%,7%,795,31499,2.46%,97.54%,18591,11287,145,146,14,133,
0500000US45025,"Chesterfield County, South Carolina",45833,23529,51.34%,48.66%,47.5,3112,6.79%,1632,1340,127,12490,2400,2618,1335,24812,3953,14122,3740,2745,30.81%,8.16%,6%,2086,41187,4.55%,95.45%,25829,13150,184,269,4,118,
0500000US45027,"Clarendon County, South Carolina",33865,17117,50.55%,49.46%,42.9,3322,9.81%,1114,1121,93,8891,2025,2456,1394,19566,3850,10005,3146,2549,29.54%,9.29%,8%,907,30237,2.68%,97.32%,15309,13821,120,225,8,73,
0500000US45029,"Colleton County, South Carolina",37624,19636,52.19%,47.81%,42.1,2364,6.28%,1380,855,217,11594,2827,2808,1468,22981,4276,12974,3682,3025,34.48%,9.79%,8%,1380,37224,3.67%,96.33%,21816,13401,302,186,16,101,
0500000US45031,"Darlington County, South Carolina",66858,35353,52.88%,47.12%,40.7,5678,8.49%,1757,2341,581,17011,4130,5173,2969,38415,8142,18768,6471,5754,28.07%,9.68%,9%,1396,61509,2.09%,97.91%,33821,25386,136,290,4,128,
0500000US45033,"Dillon County, South Carolina",30473,16163,53.04%,46.96%,39.9,3223,10.58%,962,1310,14,7788,1527,1697,925,15921,2622,8750,2837,1711,28.71%,9.31%,6%,856,27436,2.81%,97.19%,12987,12709,603,63,1,75,
0500000US45035,"Dorchester County, South Carolina",161309,82763,51.31%,48.69%,50.1,8794,5.45%,5821,3940,810,28410,12153,20175,10525,96833,30700,34231,16093,20985,21.22%,9.98%,13%,10861,150679,6.73%,93.27%,99145,38278,886,3286,199,793,
0500000US45037,"Edgefield County, South Carolina",27021,12570,46.52%,53.48%,44.4,1595,5.90%,1118,736,102,7057,1869,1997,1538,16310,3535,8175,2605,2099,30.25%,9.64%,8%,1371,24286,5.07%,94.93%,14890,8301,67,118,6,93,
0500000US45039,"Fairfield County, South Carolina",22406,11749,52.44%,47.56%,46.2,2185,9.75%,768,638,148,6417,1426,1914,981,14021,2895,7185,2064,2062,32.07%,9.21%,9%,423,20525,1.89%,98.11%,8503,11201,64,101,7,55,
0500000US45041,"Florence County, South Carolina",138237,73540,53.20%,46.80%,43.8,11007,7.96%,3946,5082,1049,30356,9720,14179,8450,80401,22629,34302,14802,15228,24.81%,10.71%,11%,4283,132776,3.10%,96.90%,69021,56877,330,2309,48,364,
0500000US45043,"Georgetown County, South Carolina",62150,32733,52.67%,47.33%,50.9,3694,5.94%,1161,2210,169,12616,4517,8398,5416,41451,13814,13777,6727,8567,22.17%,10.82%,14%,2225,61179,3.58%,96.42%,41186,18051,111,258,27,130,
0500000US45045,"Greenville County, South Carolina",516126,265679,51.48%,48.52%,50.5,24410,4.73%,14743,18651,5927,82915,32675,81357,46658,313732,128015,97658,51326,87284,18.92%,9.94%,17%,58025,467509,11.24%,88.76%,343897,87124,893,12875,398,2345,
0500000US45047,"Greenwood County, South Carolina",70672,37768,53.44%,46.56%,42.3,5859,8.29%,1539,3802,384,15319,6130,7592,3992,41098,11584,16858,9932,7976,23.85%,14.05%,11%,4749,64602,6.72%,93.28%,40625,20820,102,678,41,185,
0500000US45049,"Hampton County, South Carolina",19223,9275,48.25%,51.75%,43.4,1397,7.27%,843,396,5,5659,1298,1095,436,11019,1531,6502,1694,1100,33.82%,8.81%,6%,666,17895,3.46%,96.54%,7802,9536,41,100,17,40,
0500000US45051,"Horry County, South Carolina",344186,178073,51.74%,48.26%,47.9,21960,6.38%,8358,11876,1858,82767,26247,40180,21955,232987,62135,91125,38123,42038,26.48%,11.08%,12%,24304,326725,7.06%,92.94%,265729,39367,1174,4578,303,1422,
0500000US45053,"Jasper County, South Carolina",29558,14726,49.82%,50.18%,42.8,2354,7.96%,1124,548,128,7808,1619,3161,1322,18141,4483,8932,2167,3289,30.22%,7.33%,11%,5079,23712,17.18%,82.82%,13056,9559,59,187,23,108,
0500000US45055,"Kershaw County, South Carolina",65926,33808,51.28%,48.72%,49.2,4763,7.22%,1929,1636,348,16925,4677,6149,3551,41116,9700,18854,6313,6497,28.60%,9.58%,10%,3466,61937,5.26%,94.74%,43391,15083,146,417,29,239,
0500000US45057,"Lancaster County, South Carolina",95378,49179,51.56%,48.44%,51.2,5290,5.55%,2498,2231,761,19549,7646,12125,7417,59790,19542,22047,9877,12886,23.12%,10.36%,14%,6294,89722,6.60%,93.40%,64927,19101,220,1765,14,337,
0500000US45059,"Laurens County, South Carolina",66990,34418,51.38%,48.62%,45.7,5489,8.19%,2158,2614,428,16269,4747,5352,2604,38017,7956,18427,7361,5780,27.51%,10.99%,9%,4147,63392,6.19%,93.81%,44358,15937,144,295,24,238,
0500000US45061,"Lee County, South Carolina",17144,8394,48.96%,51.04%,34.4,1660,9.68%,788,775,69,4758,1168,1104,678,9792,1782,5546,1943,1173,32.35%,11.33%,7%,295,16236,1.72%,98.28%,5721,10054,49,34,0,15,
0500000US45063,"Lexington County, South Carolina",295033,151443,51.33%,48.67%,51.3,15154,5.14%,7895,8677,2533,56717,19983,40319,22561,183683,62880,64612,28660,42852,21.90%,9.71%,15%,21797,272194,7.39%,92.61%,208854,42382,894,6644,185,1089,
0500000US45065,"McCormick County, South Carolina",9495,4202,44.26%,55.75%,50.8,730,7.69%,212,159,8,2699,987,982,666,6577,1648,2911,1146,990,30.66%,12.07%,10%,123,9403,1.30%,98.70%,5155,3916,27,36,2,32,
0500000US45067,"Marion County, South Carolina",30954,16700,53.95%,46.05%,34.8,3996,12.91%,933,945,190,9261,1622,1657,1125,16971,2782,10194,2567,1847,32.93%,8.29%,6%,710,28473,2.29%,97.71%,11080,16333,109,128,0,42,
0500000US45069,"Marlboro County, South Carolina",26376,12886,48.86%,51.15%,35.3,3500,13.27%,1024,548,6,8404,1445,879,570,14644,1449,9428,1993,885,35.74%,7.56%,3%,575,26092,2.18%,97.82%,10556,13302,1130,99,7,39,
0500000US45071,"Newberry County, South Carolina",38329,19799,51.66%,48.35%,48.9,3060,7.98%,1437,1406,264,9347,2848,3604,1458,22196,5062,10784,4254,3868,28.14%,11.10%,10%,3305,34414,8.62%,91.38%,22635,10360,107,135,4,72,
0500000US45073,"Oconee County, South Carolina",78314,39723,50.72%,49.28%,53.2,4459,5.69%,2064,2430,585,16379,5648,9387,6207,48863,15594,18443,8078,9972,23.55%,10.31%,13%,4384,74223,5.60%,94.40%,64696,5119,176,591,16,182,
0500000US45075,"Orangeburg County, South Carolina",86953,46384,53.34%,46.66%,36.1,8183,9.41%,2929,4495,260,19019,8639,6139,5361,50777,11500,21948,13134,6399,25.24%,15.10%,7%,1967,82256,2.26%,97.74%,27787,50802,467,892,37,200,
0500000US45077,"Pickens County, South Carolina",125381,62768,50.06%,49.94%,47,10847,8.65%,4446,13813,2446,22737,8974,12098,9213,68539,21311,27183,22787,14544,21.68%,18.17%,12%,6572,124832,5.24%,94.76%,107247,8421,304,2723,37,426,
0500000US45079,"Richland County, South Carolina",414660,214144,51.64%,48.36%,38.2,34414,8.30%,19381,32374,7077,57452,22377,59924,42487,239613,102411,76833,54751,67001,18.53%,13.20%,16%,26095,390052,6.29%,93.71%,172644,188141,888,11330,427,1872,
0500000US45081,"Saluda County, South Carolina",20292,10115,49.85%,50.15%,52.1,1514,7.46%,450,599,65,4923,1414,1633,996,11407,2629,5373,2013,1698,26.48%,9.92%,8%,3012,15850,14.84%,85.16%,11264,4028,44,35,0,38,
0500000US45083,"Spartanburg County, South Carolina",313791,161493,51.47%,48.54%,48.8,20243,6.45%,9914,12821,2338,65175,22439,33056,19724,185211,52780,75089,35260,35394,23.93%,11.24%,11%,27732,300265,8.84%,91.16%,214440,63565,699,8176,190,1102,
0500000US45085,"Sumter County, South Carolina",106675,55086,51.64%,48.36%,45.5,7873,7.38%,4407,4469,590,22094,7547,8922,5712,61108,14634,26501,12016,9512,24.84%,11.26%,9%,4302,101254,4.03%,95.97%,46442,48536,338,1400,87,316,
0500000US45087,"Union County, South Carolina",27325,14308,52.36%,47.64%,48,2287,8.37%,725,742,111,7797,2016,1895,730,16396,2625,8522,2758,2006,31.19%,10.09%,7%,438,26806,1.60%,98.40%,17279,8435,56,78,3,49,
0500000US45089,"Williamsburg County, South Carolina",30810,16206,52.60%,47.40%,43.1,3527,11.45%,965,801,191,9632,1793,1955,1196,18330,3151,10597,2594,2146,34.39%,8.42%,7%,619,30407,2.01%,97.99%,9986,19579,85,147,1,61,
0500000US45091,"York County, South Carolina",273887,141817,51.78%,48.22%,52.4,11202,4.09%,7539,9857,2386,46190,19520,40806,21612,168704,62418,53729,29377,43192,19.62%,10.73%,16%,18938,263152,6.91%,93.09%,188015,51298,1892,8745,111,1145,
0500000US46003,"Aurora County, South Dakota",2757,1302,47.23%,52.78%,58.3,58,2.10%,44,98,14,650,292,274,90,1586,364,694,390,288,25.17%,14.15%,10%,219,2528,7.94%,92.06%,2409,14,38,13,0,0,
0500000US46005,"Beadle County, South Dakota",18338,9027,49.23%,50.77%,58.4,1072,5.85%,441,379,80,4182,1250,1893,989,10408,2882,4623,1629,1973,25.21%,8.88%,11%,2741,16408,14.95%,85.05%,13369,142,243,2068,57,28,
0500000US46007,"Bennett County, South Dakota",3430,1811,52.80%,47.20%,35.7,667,19.45%,109,124,0,541,168,351,67,1581,418,650,292,351,18.95%,8.51%,10%,87,3294,2.54%,97.46%,997,7,2060,7,0,2,
0500000US46009,"Bon Homme County, South Dakota",6914,2821,40.80%,59.20%,47.7,228,3.30%,261,88,115,1750,616,727,299,4432,1026,2011,704,842,29.09%,10.18%,12%,117,6886,1.69%,98.31%,6160,106,455,11,5,6,
0500000US46011,"Brookings County, South Dakota",35115,17162,48.87%,51.13%,41.8,2090,5.95%,1903,5754,1185,4728,1821,4991,2969,18157,7960,6631,7575,6176,18.88%,21.57%,18%,1427,32948,4.06%,95.94%,29922,628,372,912,13,64,
0500000US46013,"Brown County, South Dakota",38988,19827,50.85%,49.15%,51.2,1680,4.31%,1063,1991,438,7742,3097,5604,2562,24140,8166,8805,5088,6042,22.58%,13.05%,15%,1659,36642,4.26%,95.74%,32705,535,1103,918,44,96,
0500000US46015,"Brule County, South Dakota",5233,2631,50.28%,49.72%,56,219,4.18%,71,156,105,1198,398,687,244,3163,931,1269,554,792,24.25%,10.59%,15%,106,5141,2.03%,97.97%,4340,28,495,26,5,6,
0500000US46017,"Buffalo County, South Dakota",2005,936,46.68%,53.32%,32.2,522,26.03%,86,64,0,389,92,68,15,801,83,475,156,68,23.69%,7.78%,3%,13,1935,0.65%,99.35%,286,0,1582,1,0,0,
0500000US46019,"Butte County, South Dakota",10295,5231,50.81%,49.19%,53.2,513,4.98%,246,176,22,3001,514,1122,388,6523,1510,3247,690,1144,31.54%,6.70%,11%,410,9833,3.98%,96.02%,9147,12,182,30,5,30,
0500000US46021,"Campbell County, South Dakota",1458,668,45.82%,54.18%,66,18,1.23%,11,12,13,341,89,285,28,988,313,352,101,298,24.14%,6.93%,20%,37,1340,2.54%,97.46%,1270,0,31,6,0,0,
0500000US46023,"Charles Mix County, South Dakota",9324,4692,50.32%,49.68%,48.5,938,10.06%,316,263,47,2077,737,913,255,5070,1168,2393,1000,960,25.66%,10.73%,10%,228,9145,2.45%,97.55%,5720,15,3011,31,14,3,
0500000US46025,"Clark County, South Dakota",3715,1812,48.78%,51.23%,60.8,120,3.23%,99,87,24,1058,248,378,92,2303,470,1157,335,402,31.14%,9.02%,11%,169,3668,4.55%,95.45%,3573,12,20,2,2,0,
0500000US46027,"Clay County, South Dakota",14076,7172,50.95%,49.05%,36.5,1529,10.86%,1054,2938,467,1555,451,1881,1585,6649,3466,2609,3389,2348,18.54%,24.08%,17%,458,14509,3.25%,96.75%,12655,235,552,361,4,38,
0500000US46029,"Codington County, South Dakota",28133,14080,50.05%,49.95%,53.6,1785,6.34%,771,932,198,6883,2818,2856,985,17569,3841,7654,3750,3054,27.21%,13.33%,11%,739,27586,2.63%,97.37%,25841,109,645,197,3,48,
0500000US46031,"Corson County, South Dakota",4106,2040,49.68%,50.32%,37.5,996,24.26%,151,77,10,780,306,298,67,1919,365,931,383,308,22.67%,9.33%,8%,46,3856,1.12%,98.88%,957,6,2702,20,0,0,
0500000US46033,"Custer County, South Dakota",8826,4374,49.56%,50.44%,63.8,532,6.03%,217,82,66,2594,733,1121,513,6597,1634,2811,815,1187,31.85%,9.23%,13%,211,8107,2.39%,97.61%,7506,32,161,25,0,42,
0500000US46035,"Davison County, South Dakota",19890,10155,51.06%,48.94%,52.4,1034,5.20%,443,1079,113,4350,1524,2609,899,12267,3508,4793,2603,2722,24.10%,13.09%,14%,913,19043,4.59%,95.41%,17625,127,602,117,0,29,
0500000US46037,"Day County, South Dakota",5452,2670,48.97%,51.03%,55.4,330,6.05%,116,104,23,1436,553,669,208,3592,877,1552,657,692,28.47%,12.05%,13%,153,5296,2.81%,97.19%,4595,3,536,19,4,1,
0500000US46039,"Deuel County, South Dakota",4309,2069,48.02%,51.98%,65,92,2.14%,102,133,44,1056,377,549,134,2772,683,1158,510,593,26.87%,11.84%,14%,137,4158,3.18%,96.82%,4045,10,26,2,5,1,
0500000US46041,"Dewey County, South Dakota",5841,2862,49.00%,51.00%,34.5,902,15.44%,308,66,4,1097,326,379,160,2607,539,1405,392,383,24.05%,6.71%,7%,81,5158,1.39%,98.61%,849,9,4082,6,0,4,
0500000US46043,"Douglas County, South Dakota",2913,1475,50.64%,49.37%,72.4,130,4.46%,89,61,4,623,293,271,90,1767,361,712,354,275,24.44%,12.15%,9%,54,2781,1.85%,98.15%,2653,7,33,3,1,1,
0500000US46045,"Edmunds County, South Dakota",3876,1831,47.24%,52.76%,63.6,35,0.90%,104,78,12,896,328,529,152,2460,681,1000,406,541,25.80%,10.47%,14%,61,3925,1.57%,98.43%,3779,12,39,23,0,0,
0500000US46047,"Fall River County, South Dakota",6721,3242,48.24%,51.76%,48.3,302,4.49%,56,112,0,1935,569,652,380,4765,1032,1991,681,652,29.62%,10.13%,10%,180,6793,2.68%,97.32%,5932,35,391,47,11,29,
0500000US46049,"Faulk County, South Dakota",2315,1243,53.69%,46.31%,58.1,56,2.42%,14,40,61,476,237,250,235,1570,485,490,277,311,21.17%,11.97%,13%,46,2079,1.99%,98.01%,2003,2,45,3,0,1,
0500000US46051,"Grant County, South Dakota",7125,3403,47.76%,52.24%,66,300,4.21%,109,187,75,1868,553,846,267,4516,1113,1977,740,921,27.75%,10.39%,13%,480,7076,6.74%,93.26%,6806,0,71,16,3,8,
0500000US46053,"Gregory County, South Dakota",4193,2019,48.15%,51.85%,56.5,275,6.56%,99,72,14,1042,331,426,206,2683,632,1141,403,440,27.21%,9.61%,10%,52,3942,1.24%,98.76%,3491,9,264,21,4,2,
0500000US46055,"Haakon County, South Dakota",1935,1058,54.68%,45.32%,65.1,197,10.18%,6,21,10,559,134,201,13,1223,214,565,155,211,29.20%,8.01%,11%,19,1853,0.98%,99.02%,1717,2,34,14,2,14,
0500000US46057,"Hamlin County, South Dakota",6104,2962,48.53%,51.47%,64.7,90,1.47%,222,157,11,1490,385,633,173,3402,806,1712,542,644,28.05%,8.88%,11%,288,5876,4.72%,95.28%,5666,5,41,13,6,11,
0500000US46059,"Hand County, South Dakota",3064,1508,49.22%,50.78%,66,62,2.02%,49,122,59,686,326,387,93,2005,480,735,448,446,23.99%,14.62%,15%,49,3096,1.60%,98.40%,2992,7,11,7,0,14,
0500000US46061,"Hanson County, South Dakota",3423,1707,49.87%,50.13%,53.6,29,0.85%,92,117,16,740,464,240,101,1950,341,832,581,256,24.31%,16.97%,7%,33,3428,0.96%,99.04%,3316,5,6,0,0,15,
0500000US46063,"Harding County, South Dakota",1178,513,43.55%,56.45%,63.1,41,3.48%,22,24,12,298,73,180,32,810,212,320,97,192,27.16%,8.23%,16%,32,1279,2.72%,97.28%,1205,5,29,0,0,7,
0500000US46065,"Hughes County, South Dakota",17560,8919,50.79%,49.21%,52.5,866,4.93%,666,178,165,3369,1393,3133,1323,11637,4456,4035,1571,3298,22.98%,8.95%,19%,490,17275,2.79%,97.21%,14085,83,2068,128,4,51,
0500000US46067,"Hutchinson County, South Dakota",7308,3736,51.12%,48.88%,61.5,303,4.15%,153,161,27,1627,681,858,290,4458,1148,1780,842,885,24.36%,11.52%,12%,157,7270,2.15%,97.85%,7009,9,88,21,0,17,
0500000US46069,"Hyde County, South Dakota",1446,714,49.38%,50.62%,62.3,20,1.38%,18,33,2,381,165,145,101,1008,246,399,198,147,27.59%,13.69%,10%,24,1238,1.66%,98.34%,1088,4,99,5,1,3,
0500000US46071,"Jackson County, South Dakota",3296,1695,51.43%,48.57%,37.1,1037,31.46%,93,145,0,739,207,237,55,1635,292,832,352,237,25.24%,10.68%,7%,61,2745,1.85%,98.15%,1045,11,1509,7,3,4,
0500000US46073,"Jerauld County, South Dakota",2009,1009,50.22%,49.78%,65.3,15,0.75%,9,37,0,627,189,230,92,1371,322,636,226,230,31.66%,11.25%,11%,74,1589,3.68%,96.32%,1545,0,11,3,0,0,
0500000US46075,"Jones County, South Dakota",873,456,52.23%,47.77%,54.8,75,8.59%,9,2,6,264,75,141,45,614,186,273,77,147,31.27%,8.82%,17%,11,906,1.26%,98.74%,773,4,49,0,0,2,
0500000US46077,"Kingsbury County, South Dakota",4936,2404,48.70%,51.30%,63.5,189,3.83%,118,70,87,1341,390,569,243,3198,812,1459,460,656,29.56%,9.32%,13%,119,5068,2.41%,97.59%,4926,5,25,11,7,2,
0500000US46079,"Lake County, South Dakota",12747,6114,47.96%,52.04%,53.8,164,1.29%,423,681,197,2440,731,2118,777,7954,2895,2863,1412,2315,22.46%,11.08%,18%,606,10453,4.75%,95.25%,9849,85,114,66,11,28,
0500000US46081,"Lawrence County, South Dakota",25806,13023,50.47%,49.54%,48.7,1676,6.49%,816,1841,226,4759,1528,4288,2011,16937,6299,5575,3369,4514,21.60%,13.06%,17%,922,24846,3.57%,96.43%,22935,128,486,196,18,51,
0500000US46083,"Lincoln County, South Dakota",58887,29877,50.74%,49.26%,58.3,1521,2.58%,1384,1539,792,9781,5290,9563,4403,36396,13966,11165,6829,10355,18.96%,11.60%,18%,1679,63482,2.85%,97.15%,58509,1116,432,993,9,154,
0500000US46085,"Lyman County, South Dakota",3831,1818,47.46%,52.55%,44.5,474,12.37%,150,76,29,860,171,433,122,2161,555,1010,247,462,26.36%,6.45%,12%,45,3673,1.17%,98.83%,1915,3,1627,4,0,1,
0500000US46087,"McCook County, South Dakota",5543,2754,49.68%,50.32%,64.1,285,5.14%,132,208,25,1280,445,578,317,3262,895,1412,653,603,25.47%,11.78%,11%,175,5507,3.16%,96.84%,5277,9,51,4,0,10,
0500000US46089,"McPherson County, South Dakota",2316,1206,52.07%,47.93%,58,135,5.83%,96,32,11,558,166,294,95,1397,389,654,198,305,28.24%,8.55%,13%,53,2358,2.29%,97.71%,2265,3,27,3,1,0,
0500000US46091,"Marshall County, South Dakota",4881,2347,48.08%,51.92%,60.1,169,3.46%,67,196,13,1068,642,711,177,3196,888,1135,838,724,23.25%,17.17%,15%,255,4051,5.22%,94.78%,3599,6,324,12,1,0,
0500000US46093,"Meade County, South Dakota",28149,13529,48.06%,51.94%,57.9,908,3.23%,1162,1260,282,5634,2638,3477,1408,17797,4885,6796,3898,3759,24.14%,13.85%,13%,1301,28551,4.62%,95.38%,25294,408,784,275,48,87,
0500000US46095,"Mellette County, South Dakota",2065,1059,51.28%,48.72%,37.6,559,27.07%,85,37,0,519,118,138,36,1077,174,604,155,138,29.25%,7.51%,7%,39,1879,1.89%,98.11%,651,1,1101,3,0,7,
0500000US46097,"Miner County, South Dakota",2213,1090,49.25%,50.75%,58.9,178,8.04%,83,39,0,651,131,260,50,1403,310,734,170,260,33.17%,7.68%,12%,42,2256,1.90%,98.10%,2183,4,8,6,0,5,
0500000US46099,"Minnehaha County, South Dakota",191682,95168,49.65%,50.35%,50.2,7973,4.16%,4855,7034,2716,33087,15722,29293,13166,117398,42459,37942,22756,32009,19.79%,11.87%,17%,12034,185180,6.28%,93.72%,155740,11411,4807,4568,71,554,
0500000US46101,"Moody County, South Dakota",6508,3170,48.71%,51.29%,59.1,362,5.56%,184,114,75,1386,513,829,291,4087,1120,1570,627,904,24.12%,9.63%,14%,314,6022,4.82%,95.18%,4828,19,740,86,0,25,
0500000US46102,"Oglala Lakota County, South Dakota",14277,7347,51.46%,48.54%,21.7,3715,26.02%,478,619,54,1851,596,501,315,5437,816,2329,1215,555,16.31%,8.51%,4%,402,13270,2.82%,97.18%,438,24,12530,39,0,5,
0500000US46103,"Pennington County, South Dakota",112504,55630,49.45%,50.55%,47.6,6421,5.71%,3444,3865,816,22395,7959,15834,8645,72281,24479,25839,11824,16650,22.97%,10.51%,15%,5575,103647,4.96%,95.04%,82743,1363,10927,1463,78,411,
0500000US46105,"Perkins County, South Dakota",2996,1463,48.83%,51.17%,60.9,41,1.37%,79,116,12,717,318,325,110,1878,435,796,434,337,26.57%,14.49%,11%,38,2797,1.27%,98.73%,2651,2,64,5,3,8,
0500000US46107,"Potter County, South Dakota",2311,1170,50.63%,49.37%,59.1,123,5.32%,29,110,19,615,170,272,107,1519,379,644,280,291,27.87%,12.12%,13%,39,2433,1.69%,98.31%,2314,6,55,14,0,3,
0500000US46109,"Roberts County, South Dakota",10310,5063,49.11%,50.89%,47.3,773,7.50%,326,293,62,2371,1025,831,268,5990,1099,2697,1318,893,26.16%,12.78%,9%,215,10065,2.09%,97.91%,5577,32,3932,27,0,18,
0500000US46111,"Sanborn County, South Dakota",2372,1174,49.49%,50.51%,58.6,70,2.95%,44,88,22,682,221,222,94,1497,316,726,309,244,30.61%,13.03%,10%,57,2273,2.40%,97.60%,2182,0,20,9,0,0,
0500000US46115,"Spink County, South Dakota",6438,3159,49.07%,50.93%,55.7,196,3.04%,111,178,47,1536,501,938,234,4121,1172,1647,679,985,25.58%,10.55%,15%,143,6218,2.22%,97.78%,5995,23,61,2,0,1,
0500000US46117,"Stanley County, South Dakota",3058,1379,45.10%,54.91%,65.2,30,0.98%,59,86,18,816,220,362,283,2150,645,875,306,380,28.61%,10.01%,12%,31,2949,1.01%,98.99%,2553,12,193,5,9,5,
0500000US46119,"Sully County, South Dakota",1278,576,45.07%,54.93%,66.4,69,5.40%,18,25,8,353,142,178,36,940,214,371,167,186,29.03%,13.07%,15%,42,1404,3.29%,96.71%,1334,5,10,6,0,0,
0500000US46121,"Todd County, South Dakota",10308,5223,50.67%,49.33%,22.3,3645,35.36%,320,159,5,1717,211,414,268,3963,682,2037,370,419,19.76%,3.59%,4%,222,9097,2.15%,97.85%,685,10,8122,45,0,0,
0500000US46123,"Tripp County, South Dakota",5448,2745,50.39%,49.62%,54.9,521,9.56%,96,121,19,1577,393,598,186,3370,784,1673,514,617,30.71%,9.43%,11%,54,5570,0.99%,99.01%,4312,10,972,5,0,4,
0500000US46125,"Turner County, South Dakota",8325,4169,50.08%,49.92%,63.7,381,4.58%,80,214,127,1852,851,1145,370,5352,1515,1932,1065,1272,23.21%,12.79%,15%,249,8424,2.99%,97.01%,8043,37,54,12,2,13,
0500000US46127,"Union County, South Dakota",15659,7719,49.29%,50.71%,59.5,705,4.50%,213,290,386,3124,1357,2035,1240,10126,3275,3337,1647,2421,21.31%,10.52%,15%,661,16150,4.22%,95.78%,14994,169,120,247,27,29,
0500000US46129,"Walworth County, South Dakota",5431,2782,51.22%,48.78%,53.2,248,4.57%,129,109,79,1544,378,567,252,3386,819,1673,487,646,30.80%,8.97%,12%,99,5216,1.82%,98.18%,4116,8,786,11,0,9,
0500000US46135,"Yankton County, South Dakota",22746,11004,48.38%,51.62%,53.2,757,3.33%,661,802,224,5116,1731,2391,1848,14366,4239,5777,2533,2615,25.40%,11.14%,11%,1234,22076,5.43%,94.57%,20195,312,638,129,9,41,
0500000US46137,"Ziebach County, South Dakota",2767,1394,50.38%,49.62%,29.4,556,20.09%,157,101,0,682,150,222,42,1437,264,839,251,222,30.32%,9.07%,8%,34,2379,1.23%,98.77%,404,0,1899,3,3,2,
0500000US47001,"Anderson County, Tennessee",76513,39159,51.18%,48.82%,52.7,4541,5.93%,2536,1968,355,18791,4521,6848,5647,48517,12495,21327,6489,7203,27.87%,8.48%,9%,2820,74303,3.69%,96.31%,66044,2841,217,975,53,272,
0500000US47003,"Bedford County, Tennessee",48937,24840,50.76%,49.24%,51,2895,5.92%,1936,1187,202,13252,1562,3947,1958,27174,5905,15188,2749,4149,31.04%,5.62%,8%,7665,42572,15.66%,84.34%,36499,3563,127,337,13,140,
0500000US47005,"Benton County, Tennessee",16133,8175,50.67%,49.33%,46.4,1239,7.68%,357,503,38,5514,759,1078,432,9809,1510,5871,1262,1116,36.39%,7.82%,7%,375,15489,2.32%,97.68%,14378,316,50,107,4,30,
0500000US47007,"Bledsoe County, Tennessee",14961,6003,40.12%,59.88%,46.6,1128,7.54%,352,289,68,5219,797,765,577,9215,1342,5571,1086,833,37.24%,7.26%,6%,459,14454,3.07%,96.93%,13129,781,48,37,0,2,
0500000US47009,"Blount County, Tennessee",131641,67808,51.51%,48.49%,55.1,5479,4.16%,4048,4391,816,33513,7432,14728,8600,84739,23328,37561,11823,15544,28.53%,8.98%,12%,5709,129571,4.34%,95.66%,117952,3552,339,1280,23,439,
0500000US47011,"Bradley County, Tennessee",106924,54934,51.38%,48.62%,51.7,6281,5.87%,3405,5302,802,23611,6438,10854,6335,63718,17189,27016,11740,11656,25.27%,10.98%,11%,8461,100159,7.91%,92.09%,87830,5105,271,1188,117,348,
0500000US47013,"Campbell County, Tennessee",39818,20270,50.91%,49.09%,50.2,2734,6.87%,1208,988,120,11160,1821,2315,1405,22746,3720,12368,2809,2435,31.06%,7.05%,6%,500,38772,1.26%,98.74%,37101,130,77,94,0,87,
0500000US47015,"Cannon County, Tennessee",14374,7261,50.52%,49.49%,51.4,1215,8.45%,549,257,70,4716,501,1078,603,8652,1681,5265,758,1148,36.63%,5.27%,8%,395,14111,2.75%,97.25%,13064,192,25,38,4,41,
0500000US47017,"Carroll County, Tennessee",27841,14065,50.52%,49.48%,52.2,1754,6.30%,1120,1121,115,8274,1118,2212,1410,16841,3622,9394,2239,2327,33.74%,8.04%,8%,769,27671,2.76%,97.24%,23744,2445,75,124,5,104,
0500000US47019,"Carter County, Tennessee",56452,28849,51.10%,48.90%,50.4,3591,6.36%,1410,1730,466,16043,2717,4845,2952,35941,7797,17453,4447,5311,30.92%,7.88%,9%,1181,55175,2.09%,97.91%,51790,702,153,231,7,108,
0500000US47021,"Cheatham County, Tennessee",40539,20318,50.12%,49.88%,54.3,2155,5.32%,1434,1026,178,11083,1947,3913,1941,24725,5854,12517,2973,4091,30.88%,7.33%,10%,1839,39233,4.54%,95.46%,36299,815,92,184,25,127,
0500000US47023,"Chester County, Tennessee",17260,8973,51.99%,48.01%,50.6,1029,5.96%,563,1382,72,4780,747,1108,690,9624,1798,5343,2129,1180,30.96%,12.33%,7%,528,16813,3.06%,96.94%,14471,1494,52,70,0,62,
0500000US47025,"Claiborne County, Tennessee",31827,16363,51.41%,48.59%,53.4,3101,9.74%,998,1278,483,8432,1924,2340,1635,18355,3975,9430,3202,2823,29.63%,10.06%,9%,490,31553,1.54%,98.46%,29966,314,58,148,11,87,
0500000US47027,"Clay County, Tennessee",7640,3937,51.53%,48.47%,56.3,727,9.52%,248,227,0,2662,320,488,234,4487,722,2910,547,488,38.09%,7.16%,6%,130,7451,1.70%,98.30%,7202,76,17,5,1,4,
0500000US47029,"Cocke County, Tennessee",35797,18312,51.16%,48.85%,47.3,3298,9.21%,1299,564,88,12540,1470,1803,1143,21323,2946,13839,2034,1891,38.66%,5.68%,5%,954,35045,2.67%,97.33%,32733,582,126,150,9,46,
0500000US47031,"Coffee County, Tennessee",56024,28503,50.88%,49.12%,51.9,3058,5.46%,1957,1435,239,14630,2902,4918,3175,33227,8093,16587,4337,5157,29.61%,7.74%,9%,3259,54630,5.82%,94.18%,48983,2097,145,611,37,171,
0500000US47033,"Crockett County, Tennessee",14310,7428,51.91%,48.09%,52.8,946,6.61%,496,317,56,4019,641,964,529,8238,1493,4515,958,1020,31.55%,6.69%,7%,1498,12413,10.47%,89.53%,10056,1879,19,25,1,50,
0500000US47035,"Cumberland County, Tennessee",60016,30682,51.12%,48.88%,60.4,2918,4.86%,2117,968,115,17947,3775,4915,3120,40001,8035,20064,4743,5030,33.43%,7.90%,8%,1936,59209,3.23%,96.77%,56313,299,130,366,12,102,
0500000US47037,"Davidson County, Tennessee",690540,358013,51.85%,48.16%,41.2,42150,6.10%,18061,28755,14044,102234,29472,130657,76782,429391,207439,120295,58227,144701,17.42%,8.43%,21%,98119,617765,14.21%,85.79%,386835,171489,1309,27660,303,3210,
0500000US47039,"Decatur County, Tennessee",11663,5917,50.73%,49.27%,55.9,712,6.10%,261,336,90,3659,736,934,278,7171,1212,3920,1072,1024,33.61%,9.19%,9%,358,11077,3.07%,96.93%,10462,270,9,42,5,15,
0500000US47041,"DeKalb County, Tennessee",20104,9957,49.53%,50.47%,57.7,1430,7.11%,591,622,86,5486,847,1796,920,11407,2716,6077,1469,1882,30.23%,7.31%,9%,1449,18631,7.21%,92.79%,17526,234,44,76,5,53,
0500000US47043,"Dickson County, Tennessee",53289,27043,50.75%,49.25%,51.1,2590,4.86%,1652,1422,106,14952,2646,4024,2342,31768,6366,16604,4068,4130,31.16%,7.63%,8%,2582,51733,4.85%,95.15%,46994,1931,181,310,4,160,
0500000US47045,"Dyer County, Tennessee",37201,19169,51.53%,48.47%,48.9,2900,7.80%,1260,1413,150,9070,2229,2911,1774,21620,4685,10330,3642,3061,27.77%,9.79%,8%,1303,35498,3.50%,96.50%,28272,5335,81,213,11,100,
0500000US47047,"Fayette County, Tennessee",40612,20553,50.61%,49.39%,55.2,2225,5.48%,1125,1067,228,10047,2303,4401,2363,26396,6764,11172,3370,4629,27.51%,8.30%,11%,1430,40560,3.52%,96.48%,27558,11038,59,269,18,158,
0500000US47049,"Fentress County, Tennessee",18405,9189,49.93%,50.07%,51.9,564,3.06%,670,527,31,5440,913,1595,604,10665,2199,6110,1440,1626,33.20%,7.82%,9%,316,18173,1.72%,98.28%,17541,25,26,33,0,18,
0500000US47051,"Franklin County, Tennessee",41999,21439,51.05%,48.95%,51.4,2883,6.86%,1727,2445,261,12154,2023,3570,2428,25424,5998,13881,4468,3831,33.05%,10.64%,9%,1502,41272,3.58%,96.42%,36864,1962,117,348,17,237,
0500000US47053,"Gibson County, Tennessee",49193,25595,52.03%,47.97%,50.1,2882,5.86%,1843,1173,309,12954,2291,3870,2114,28739,5984,14797,3464,4179,30.08%,7.04%,8%,1439,48990,2.93%,97.07%,37930,8929,97,200,15,112,
0500000US47055,"Giles County, Tennessee",29403,14995,51.00%,49.00%,47.7,1763,6.00%,775,1286,91,9244,1292,2555,1162,18044,3717,10019,2578,2646,34.07%,8.77%,9%,728,29618,2.48%,97.52%,24920,2927,113,176,9,75,
0500000US47057,"Grainger County, Tennessee",23268,11895,51.12%,48.88%,56,1609,6.92%,835,570,116,6973,1192,1413,759,13538,2172,7808,1762,1529,33.56%,7.57%,7%,773,22754,3.32%,96.68%,21748,118,42,53,2,33,
0500000US47059,"Greene County, Tennessee",69077,35241,51.02%,48.98%,48.9,4293,6.21%,2355,2504,219,21341,3234,5099,2935,42262,8034,23696,5738,5318,34.30%,8.31%,8%,2535,67617,3.67%,96.33%,63143,1308,142,299,14,194,
0500000US47061,"Grundy County, Tennessee",13371,6756,50.53%,49.47%,54.1,981,7.34%,574,300,26,4018,649,624,638,7378,1262,4592,949,650,34.34%,7.10%,5%,175,13354,1.31%,98.69%,12620,38,33,44,0,22,
0500000US47063,"Hamblen County, Tennessee",64479,32870,50.98%,49.02%,50.7,4648,7.21%,2322,1562,432,17011,3373,5322,2696,36804,8018,19333,4935,5754,29.98%,7.65%,9%,9483,55016,14.71%,85.29%,49197,2106,130,712,268,152,
0500000US47065,"Hamilton County, Tennessee",364718,188524,51.69%,48.31%,47.3,20673,5.67%,7670,17590,3441,67509,23692,55330,30300,232225,85630,75179,41282,58771,20.61%,11.32%,16%,27075,339132,7.42%,92.58%,249939,63979,770,8139,131,1269,
0500000US47067,"Hancock County, Tennessee",6568,3302,50.27%,49.73%,48.4,961,14.63%,260,115,34,1984,203,184,321,3837,505,2244,318,218,34.17%,4.84%,3%,40,6622,0.61%,99.39%,6391,33,25,1,0,11,
0500000US47069,"Hardeman County, Tennessee",25247,11344,44.93%,55.07%,40.1,1342,5.32%,992,885,83,8317,1000,1310,603,14706,1913,9309,1885,1393,36.87%,7.47%,6%,494,24968,1.96%,98.04%,13970,10150,46,162,6,68,
0500000US47071,"Hardin County, Tennessee",25665,13178,51.35%,48.65%,54.5,1463,5.70%,876,611,51,7790,1275,2152,912,15375,3064,8666,1886,2203,33.77%,7.35%,9%,565,26266,2.20%,97.80%,24272,805,81,148,0,53,
0500000US47073,"Hawkins County, Tennessee",56735,28977,51.07%,48.93%,52.1,4136,7.29%,1811,1654,366,17437,3010,4607,2279,35756,6886,19248,4664,4973,33.93%,8.22%,9%,889,55832,1.57%,98.43%,52824,671,104,256,13,110,
0500000US47075,"Haywood County, Tennessee",17391,9186,52.82%,47.18%,42.6,912,5.24%,778,360,24,5749,672,893,492,10238,1385,6527,1032,917,37.53%,5.93%,5%,838,17026,4.82%,95.18%,7554,8993,33,26,6,56,
0500000US47077,"Henderson County, Tennessee",27956,14140,50.58%,49.42%,50.4,2233,7.99%,682,936,63,8913,1457,1774,875,16587,2649,9595,2393,1837,34.32%,8.56%,7%,719,27123,2.57%,97.43%,23890,1931,53,90,2,81,
0500000US47079,"Henry County, Tennessee",32251,16882,52.35%,47.65%,52.9,2040,6.33%,1074,893,36,10849,974,2572,1562,20308,4134,11923,1867,2608,36.97%,5.79%,8%,877,31322,2.72%,97.28%,27250,2307,76,202,7,125,
0500000US47081,"Hickman County, Tennessee",25017,11811,47.21%,52.79%,51.2,837,3.35%,1088,665,53,8381,1171,1162,506,14415,1668,9469,1836,1215,37.85%,7.34%,5%,681,24244,2.72%,97.28%,22086,931,101,72,1,53,
0500000US47083,"Houston County, Tennessee",8201,4082,49.77%,50.23%,45.8,461,5.62%,332,128,17,2483,481,486,292,4645,778,2815,609,503,34.33%,7.43%,6%,202,8081,2.46%,97.54%,7491,200,32,16,8,40,
0500000US47085,"Humphreys County, Tennessee",18528,9415,50.82%,49.19%,55.4,1087,5.87%,452,519,62,6107,787,1171,751,10973,1922,6559,1306,1233,35.40%,7.05%,7%,449,18541,2.42%,97.58%,17102,494,43,57,0,74,
0500000US47087,"Jackson County, Tennessee",11767,5877,49.95%,50.06%,46.1,899,7.64%,393,348,41,4074,470,775,249,7078,1024,4467,818,816,37.96%,6.95%,7%,245,11372,2.08%,97.92%,10778,31,35,17,0,28,
0500000US47089,"Jefferson County, Tennessee",54162,27525,50.82%,49.18%,54.7,2808,5.18%,2117,2177,197,14801,3101,4244,2546,33360,6790,16918,5278,4441,31.24%,9.74%,8%,2392,52291,4.42%,95.58%,48975,787,159,257,20,157,
0500000US47091,"Johnson County, Tennessee",17755,8214,46.26%,53.74%,50.2,1696,9.55%,645,416,8,5538,963,1095,517,10888,1612,6183,1379,1103,34.82%,7.77%,6%,516,17432,2.91%,97.09%,16126,724,28,27,9,8,
0500000US47093,"Knox County, Tennessee",466184,239505,51.38%,48.62%,48.7,26871,5.76%,14994,27687,8108,77240,27242,73405,47903,287425,121308,92234,54929,81513,19.78%,11.78%,17%,28568,450403,6.13%,93.87%,373790,39853,1079,11881,300,1776,
0500000US47095,"Lake County, Tennessee",7273,2606,35.83%,64.17%,31.2,676,9.29%,364,127,0,2436,206,366,204,4140,570,2800,333,366,38.50%,4.58%,5%,175,6830,2.41%,97.59%,4755,1832,15,12,5,5,
0500000US47097,"Lauderdale County, Tennessee",25689,12529,48.77%,51.23%,44.4,1906,7.42%,1161,673,41,7825,1069,1070,626,13760,1696,8986,1742,1111,34.98%,6.78%,4%,587,24556,2.29%,97.71%,15016,8385,133,53,0,62,
0500000US47099,"Lawrence County, Tennessee",43780,22302,50.94%,49.06%,50.8,2750,6.28%,1493,1276,136,12983,2103,2373,1719,24880,4092,14476,3379,2509,33.07%,7.72%,6%,1117,43042,2.55%,97.45%,40368,694,92,167,1,120,
0500000US47101,"Lewis County, Tennessee",12131,6145,50.66%,49.35%,50,845,6.97%,431,312,37,3796,713,578,289,7130,867,4227,1025,615,34.84%,8.45%,5%,326,12256,2.69%,97.31%,11510,184,31,55,5,36,
0500000US47103,"Lincoln County, Tennessee",34158,17246,50.49%,49.51%,54.9,1531,4.48%,1221,860,108,9960,1659,2802,1790,20352,4592,11181,2519,2910,32.73%,7.37%,9%,1268,34051,3.71%,96.29%,29803,2198,116,178,16,81,
0500000US47105,"Loudon County, Tennessee",53169,27067,50.91%,49.09%,57.2,2519,4.74%,1517,1530,102,11956,3057,7003,3660,34026,10663,13473,4587,7105,25.34%,8.63%,13%,5356,49530,10.07%,89.93%,46419,578,95,450,2,161,
0500000US47107,"McMinn County, Tennessee",53392,27503,51.51%,48.49%,51,3755,7.03%,1591,1853,110,14538,3275,4183,2247,32195,6430,16129,5128,4293,30.21%,9.60%,8%,2161,51115,4.05%,95.95%,45993,1842,140,430,17,107,
0500000US47109,"McNairy County, Tennessee",25814,13237,51.28%,48.72%,52.1,1240,4.80%,859,724,102,8343,1454,1416,976,15454,2392,9202,2178,1518,35.65%,8.44%,6%,438,25428,1.70%,98.30%,22847,1545,55,78,0,51,
0500000US47111,"Macon County, Tennessee",24208,12314,50.87%,49.13%,56.9,1371,5.66%,1008,764,78,7859,1219,863,590,13166,1453,8867,1983,941,36.63%,8.19%,4%,1684,23532,6.96%,93.04%,22439,120,60,44,8,34,
0500000US47113,"Madison County, Tennessee",97838,51590,52.73%,47.27%,44.7,8111,8.29%,4134,4479,729,22518,4214,10515,6480,57978,16995,26652,8693,11244,27.24%,8.89%,11%,4722,94101,4.83%,95.17%,53264,35837,175,1227,13,359,
0500000US47115,"Marion County, Tennessee",28639,14607,51.00%,49.00%,52.7,1630,5.69%,826,942,47,8235,1607,1703,853,16581,2556,9061,2549,1750,31.64%,8.90%,6%,601,28236,2.10%,97.90%,25689,1033,93,148,2,53,
0500000US47117,"Marshall County, Tennessee",33708,17067,50.63%,49.37%,52.9,2023,6.00%,1305,737,98,9322,2098,2541,1242,20338,3783,10627,2835,2639,31.53%,8.41%,8%,2235,32083,6.63%,93.37%,28255,2018,103,142,7,93,
0500000US47119,"Maury County, Tennessee",94615,48915,51.70%,48.30%,53.3,3628,3.83%,3063,2651,431,22859,7218,10510,5225,59322,15735,25922,9869,10941,27.40%,10.43%,12%,7660,93314,8.10%,91.90%,76182,11241,248,934,45,383,
0500000US47121,"Meigs County, Tennessee",12237,6198,50.65%,49.35%,58.2,835,6.82%,381,286,2,3998,635,595,319,7507,914,4379,921,597,35.78%,7.53%,5%,220,12538,1.80%,98.20%,11823,131,58,26,1,38,
0500000US47123,"Monroe County, Tennessee",46413,23517,50.67%,49.33%,54.3,3158,6.80%,1711,988,196,13291,2580,3409,1673,28050,5082,15002,3568,3605,32.32%,7.69%,8%,1937,44313,4.17%,95.83%,41185,736,141,194,2,85,
0500000US47125,"Montgomery County, Tennessee",204992,102787,50.14%,49.86%,53.9,11151,5.44%,8800,10692,1617,34556,14088,24253,13222,118824,37475,43356,24780,25870,21.15%,12.09%,13%,22934,197135,11.19%,88.81%,131294,43349,757,5039,936,1207,
0500000US47127,"Moore County, Tennessee",6396,3225,50.42%,49.58%,61.8,197,3.08%,225,216,10,1968,399,715,190,4038,905,2193,615,725,34.29%,9.62%,11%,101,6360,1.58%,98.42%,5999,103,17,29,1,10,
0500000US47129,"Morgan County, Tennessee",21538,9802,45.51%,54.49%,50.3,1552,7.21%,916,356,105,7172,1105,981,797,12728,1778,8088,1461,1086,37.55%,6.78%,5%,299,20736,1.39%,98.61%,19029,971,54,41,8,64,
0500000US47131,"Obion County, Tennessee",30343,15690,51.71%,48.29%,49.5,2200,7.25%,763,933,174,9580,1166,2125,1188,17879,3313,10343,2099,2299,34.09%,6.92%,8%,1574,29213,5.19%,94.81%,24736,3137,50,103,0,67,
0500000US47133,"Overton County, Tennessee",22171,11289,50.92%,49.08%,53.1,1562,7.05%,786,505,104,7298,752,1240,721,12605,1961,8084,1257,1344,36.46%,5.67%,6%,344,22167,1.55%,98.45%,21223,86,60,61,0,31,
0500000US47135,"Perry County, Tennessee",8020,4027,50.21%,49.79%,58,876,10.92%,168,229,16,2400,419,282,198,4188,480,2568,648,298,32.02%,8.08%,4%,127,8239,1.58%,98.42%,7700,195,41,26,1,21,
0500000US47137,"Pickett County, Tennessee",5068,2570,50.71%,49.29%,60.3,373,7.36%,133,92,0,1522,353,323,198,3055,521,1655,445,323,32.66%,8.78%,6%,83,4918,1.64%,98.36%,4811,8,8,15,1,5,
0500000US47139,"Polk County, Tennessee",16807,8403,50.00%,50.00%,59.5,709,4.22%,630,432,66,4236,1396,944,626,10151,1570,4866,1828,1010,28.95%,10.88%,6%,297,17247,1.77%,98.23%,16313,61,59,33,10,23,
0500000US47141,"Putnam County, Tennessee",78542,39703,50.55%,49.45%,47,5697,7.25%,2785,6909,868,19223,2878,8031,5486,45111,13517,22008,9787,8899,28.02%,12.46%,11%,6256,73598,7.97%,92.03%,66782,2161,161,1086,33,179,
0500000US47143,"Rhea County, Tennessee",32964,16672,50.58%,49.42%,50.2,2211,6.71%,1203,1166,131,8573,1544,2402,1329,18542,3731,9776,2710,2533,29.66%,8.22%,8%,1960,30910,5.95%,94.05%,28641,598,100,195,6,69,
0500000US47145,"Roane County, Tennessee",53331,27220,51.04%,48.96%,54.3,2674,5.01%,1784,1435,227,14889,3432,4497,3025,35401,7522,16673,4867,4724,31.26%,9.13%,9%,1011,52393,1.90%,98.10%,48094,1302,161,341,19,157,
0500000US47147,"Robertson County, Tennessee",70982,35806,50.44%,49.56%,57.1,3180,4.48%,2735,1857,297,19029,3728,7091,2831,42462,9922,21764,5585,7388,30.66%,7.87%,10%,6878,65925,9.69%,90.31%,57049,5091,139,447,21,246,
0500000US47149,"Rutherford County, Tennessee",324139,164840,50.86%,49.15%,49.9,14354,4.43%,13020,18275,4567,56895,17467,46770,19893,189042,66663,69915,35742,51337,21.57%,11.03%,16%,38317,303169,11.82%,88.18%,219194,53270,789,12394,219,1642,
0500000US47151,"Scott County, Tennessee",22020,11106,50.44%,49.56%,49.8,1473,6.69%,803,681,44,6815,923,792,594,11847,1386,7618,1604,836,34.60%,7.28%,4%,205,21645,0.93%,99.07%,20957,32,36,51,0,6,
0500000US47153,"Sequatchie County, Tennessee",14936,7315,48.98%,51.02%,57.7,1131,7.57%,476,411,57,4537,695,1068,536,9109,1604,5013,1106,1125,33.56%,7.40%,8%,621,15205,4.16%,95.84%,14409,72,49,65,4,42,
0500000US47155,"Sevier County, Tennessee",98007,49522,50.53%,49.47%,54.8,4936,5.04%,3079,2877,382,25748,5446,8684,4154,60729,12838,28827,8323,9066,29.41%,8.49%,9%,8614,89766,8.79%,91.21%,83801,766,312,1103,24,254,
0500000US47157,"Shelby County, Tennessee",936611,492039,52.53%,47.47%,39.3,82590,8.82%,29910,35654,10066,168163,40279,119097,80192,548280,199289,198073,75933,129163,21.15%,8.11%,14%,77707,852037,8.30%,91.70%,316740,475074,1561,27960,256,3614,
0500000US47159,"Smith County, Tennessee",19926,9899,49.68%,50.32%,55.7,1187,5.96%,712,381,91,6006,915,1631,754,11932,2385,6718,1296,1722,33.71%,6.50%,9%,518,19386,2.60%,97.40%,18054,356,61,84,0,20,
0500000US47161,"Stewart County, Tennessee",13553,6981,51.51%,48.49%,51.6,620,4.57%,448,250,95,4228,701,1166,602,8461,1768,4676,951,1261,34.50%,7.02%,9%,336,13321,2.48%,97.52%,12321,171,74,76,2,45,
0500000US47163,"Sullivan County, Tennessee",157707,81010,51.37%,48.63%,50.9,9738,6.17%,4588,5209,935,39310,10189,18244,9976,100764,28220,43898,15398,19179,27.84%,9.76%,12%,3548,154615,2.25%,97.75%,143354,3197,350,1270,36,457,
0500000US47165,"Sumner County, Tennessee",187680,96074,51.19%,48.81%,54.7,8873,4.73%,4792,5625,1823,39155,11310,25503,11448,116654,36951,43947,16935,27326,23.42%,9.02%,15%,12870,183411,6.86%,93.14%,155169,15537,476,2932,116,655,
0500000US47167,"Tipton County, Tennessee",61562,31185,50.66%,49.34%,52.2,3464,5.63%,2202,1946,217,15219,3984,4550,2465,36428,7015,17421,5930,4767,28.30%,9.63%,8%,1686,59284,2.74%,97.26%,44925,10760,180,393,39,190,
0500000US47169,"Trousdale County, Tennessee",10910,4242,38.88%,61.12%,43.6,273,2.50%,551,305,53,3419,506,605,298,6623,903,3970,811,658,36.39%,7.43%,6%,375,11240,3.44%,96.56%,8786,1917,26,27,0,20,
0500000US47171,"Unicoi County, Tennessee",17821,8841,49.61%,50.39%,49.2,1758,9.86%,516,684,103,5064,1083,1538,680,11557,2218,5580,1767,1641,31.31%,9.92%,9%,1107,16821,6.21%,93.79%,16175,44,38,37,0,21,
0500000US47173,"Union County, Tennessee",19678,10026,50.95%,49.05%,54.4,1398,7.10%,765,286,81,6013,1242,822,719,10917,1541,6778,1528,903,34.44%,7.77%,5%,404,19398,2.05%,97.95%,18642,53,33,36,5,41,
0500000US47175,"Van Buren County, Tennessee",5813,2930,50.40%,49.60%,56.5,313,5.38%,200,82,13,1977,344,183,186,3388,369,2177,426,196,37.45%,7.33%,3%,83,6085,1.43%,98.57%,5866,20,7,10,1,0,
0500000US47177,"Warren County, Tennessee",40971,20508,50.06%,49.95%,51.1,3076,7.51%,1493,1132,127,12574,1684,2501,1336,23018,3837,14067,2816,2628,34.33%,6.87%,6%,3943,37010,9.62%,90.38%,33980,1090,84,258,10,138,
0500000US47179,"Washington County, Tennessee",128874,66071,51.27%,48.73%,50,8725,6.77%,5135,7035,2115,26250,6352,16664,12055,79682,28719,31385,13387,18779,24.35%,10.39%,15%,6136,126865,4.76%,95.24%,112606,5511,289,1980,53,606,
0500000US47181,"Wayne County, Tennessee",16638,7498,45.07%,54.93%,45.4,1092,6.56%,501,407,92,5675,737,802,528,10170,1330,6176,1144,894,37.12%,6.88%,5%,379,15853,2.28%,97.72%,14503,878,18,27,1,54,
0500000US47183,"Weakley County, Tennessee",33377,16983,50.88%,49.12%,49.4,2875,8.61%,1266,3520,295,9507,1148,2501,1778,18814,4279,10773,4668,2796,32.28%,13.99%,8%,905,31997,2.71%,97.29%,27813,2593,52,192,3,79,
0500000US47185,"White County, Tennessee",27087,14077,51.97%,48.03%,52,1502,5.55%,788,737,106,7833,1371,1490,942,15591,2432,8621,2108,1596,31.83%,7.78%,6%,736,26615,2.72%,97.28%,24833,405,75,132,10,56,
0500000US47187,"Williamson County, Tennessee",232380,118474,50.98%,49.02%,63.4,5076,2.18%,4892,6109,3942,19770,9846,57841,33939,144545,91780,24662,15955,61783,10.61%,6.87%,27%,14261,233465,6.14%,93.86%,200408,9709,393,12879,115,1020,
0500000US47189,"Wilson County, Tennessee",140604,71674,50.98%,49.02%,59.2,5966,4.24%,3903,4109,1317,27184,7483,22634,10957,88945,33591,31087,11592,23951,22.11%,8.24%,17%,8375,139362,5.96%,94.04%,118889,10099,405,3086,44,602,
0500000US48001,"Anderson County, Texas",57917,22479,38.81%,61.19%,43.2,2496,4.31%,1978,1115,144,16520,3154,3040,1745,34919,4785,18498,4269,3184,31.94%,7.37%,5%,11111,46811,19.18%,80.82%,33098,11430,193,381,13,113,
0500000US48003,"Andrews County, Texas",18227,9187,50.40%,49.60%,53.9,1406,7.71%,714,727,19,3656,813,1194,440,8395,1634,4370,1540,1213,23.98%,8.45%,7%,10400,8210,57.06%,42.94%,7405,192,96,102,0,49,
0500000US48005,"Angelina County, Texas",87119,44506,51.09%,48.91%,48.2,5587,6.41%,3257,3200,440,17634,4685,7153,3272,47590,10425,20891,7885,7593,23.98%,9.05%,9%,19732,66663,22.65%,77.35%,49970,12872,200,891,30,196,
0500000US48007,"Aransas County, Texas",24220,12229,50.49%,49.51%,53.7,2769,11.43%,240,455,144,5185,1529,2802,1324,15515,4126,5425,1984,2946,22.40%,8.19%,12%,6158,17672,25.43%,74.57%,15816,241,142,480,15,78,
0500000US48009,"Archer County, Texas",8754,4363,49.84%,50.16%,57.6,433,4.95%,228,327,30,2263,424,892,489,5603,1381,2491,751,922,28.46%,8.58%,11%,742,7818,8.48%,91.52%,7356,30,71,18,0,21,
0500000US48011,"Armstrong County, Texas",1950,1058,54.26%,45.74%,61.6,38,1.95%,88,65,3,318,126,232,112,1219,344,406,191,235,20.82%,9.79%,12%,144,1704,7.38%,92.62%,1593,6,17,10,0,2,
0500000US48013,"Atascosa County, Texas",50194,24991,49.79%,50.21%,51.6,2116,4.22%,2013,1471,51,12739,1363,3651,1266,25355,4917,14752,2834,3702,29.39%,5.65%,7%,31178,17803,62.11%,37.89%,16066,340,116,170,15,177,
0500000US48015,"Austin County, Texas",29892,14979,50.11%,49.89%,59.6,1160,3.88%,1092,728,152,6819,1306,3270,1411,17861,4681,7911,2034,3422,26.47%,6.80%,11%,8052,22115,26.94%,73.06%,18480,2352,78,201,8,107,
0500000US48017,"Bailey County, Texas",6916,3461,50.04%,49.96%,44,283,4.09%,577,122,0,1639,282,474,235,3180,709,2216,404,474,32.04%,5.84%,7%,4540,2364,65.64%,34.36%,2190,49,24,8,0,27,
0500000US48019,"Bandera County, Texas",22770,11443,50.26%,49.75%,53,1348,5.92%,641,592,121,5570,1511,2671,1244,15667,3915,6211,2103,2792,27.28%,9.24%,12%,4010,16841,17.61%,82.39%,15595,102,101,95,11,71,
0500000US48021,"Bastrop County, Texas",86839,42750,49.23%,50.77%,49.1,3839,4.42%,4131,2182,346,17469,3919,8326,3963,47448,12289,21600,6101,8672,24.87%,7.03%,10%,41484,55732,47.77%,52.23%,45751,5460,312,718,63,417,
0500000US48023,"Baylor County, Texas",3560,1841,51.71%,48.29%,61.5,193,5.42%,97,125,15,957,155,432,98,2209,530,1054,280,447,29.61%,7.87%,13%,439,3026,12.33%,87.67%,2797,52,11,9,0,8,
0500000US48025,"Bee County, Texas",32609,12644,38.78%,61.23%,37.1,2360,7.24%,1580,810,339,7466,1673,1248,1149,17601,2397,9046,2483,1587,27.74%,7.61%,5%,19392,11655,59.47%,40.53%,8600,2316,54,211,2,65,
0500000US48027,"Bell County, Texas",355700,178674,50.23%,49.77%,49.4,22035,6.19%,16653,16650,2953,55769,25058,36145,18747,197051,54892,72422,41708,39098,20.36%,11.73%,11%,93467,277180,26.28%,73.72%,156780,80759,1448,10884,3454,2063,
0500000US48029,"Bexar County, Texas",1978826,1001524,50.61%,49.39%,42.1,130826,6.61%,73481,85972,18179,318911,103458,227899,133605,1072136,361504,392392,189430,246078,19.83%,9.57%,12%,1190958,818366,60.19%,39.81%,535732,147875,4554,65217,2726,8218,
0500000US48031,"Blanco County, Texas",11733,5806,49.48%,50.52%,58.2,447,3.81%,389,157,95,2455,839,1724,787,8171,2511,2844,996,1819,24.24%,8.49%,16%,2092,9282,17.83%,82.17%,8707,68,36,38,0,70,
0500000US48033,"Borden County, Texas",653,344,52.68%,47.32%,67.6,7,1.07%,0,0,0,91,23,157,39,405,196,91,23,157,13.94%,3.52%,24%,86,545,13.17%,86.83%,528,1,0,0,0,1,
0500000US48035,"Bosque County, Texas",18428,9369,50.84%,49.16%,58.4,682,3.70%,512,416,54,4362,1291,1719,733,11689,2452,4874,1707,1773,26.45%,9.26%,10%,3321,14914,18.02%,81.98%,13621,244,83,80,3,29,
0500000US48037,"Bowie County, Texas",93622,46371,49.53%,50.47%,45.4,6924,7.40%,3712,2700,480,21530,4886,9049,4866,56896,13915,25242,7586,9529,26.96%,8.10%,10%,7602,85291,8.12%,91.88%,55855,23084,554,1082,69,332,
0500000US48039,"Brazoria County, Texas",368062,182089,49.47%,50.53%,54.8,12695,3.45%,10443,12758,3186,60295,21363,48006,26889,214038,74895,70738,34121,51192,19.22%,9.27%,14%,115202,256829,31.30%,68.70%,161833,53668,1022,26231,129,1374,
0500000US48041,"Brazos County, Texas",226370,112188,49.56%,50.44%,38.1,28778,12.71%,11623,35633,8415,24960,7900,27151,23209,107359,50360,36583,43533,35566,16.16%,19.23%,16%,63067,170782,27.86%,72.14%,123035,23569,502,14621,210,1009,
0500000US48043,"Brewster County, Texas",9231,4744,51.39%,48.61%,51,611,6.62%,88,282,163,1256,254,1864,928,5818,2792,1344,536,2027,14.56%,5.81%,22%,3963,5583,42.93%,57.07%,4948,162,30,94,11,56,
0500000US48045,"Briscoe County, Texas",1348,563,41.77%,58.23%,49.5,73,5.42%,62,23,21,365,70,134,44,869,178,427,93,155,31.68%,6.90%,11%,368,1067,27.30%,72.70%,1008,17,4,0,0,3,
0500000US48047,"Brooks County, Texas",7100,3554,50.06%,49.94%,37.2,1243,17.51%,238,533,0,1167,129,564,167,2991,731,1405,662,564,19.79%,9.32%,8%,6242,834,87.92%,12.08%,724,8,9,29,0,12,
0500000US48049,"Brown County, Texas",37805,18985,50.22%,49.78%,51.6,2024,5.35%,1386,1491,220,9196,1842,3916,1345,22773,5261,10582,3333,4136,27.99%,8.82%,11%,8211,29884,21.72%,78.28%,26672,1353,134,269,27,96,
0500000US48051,"Burleson County, Texas",18237,9167,50.27%,49.73%,58.3,901,4.94%,636,379,193,4682,823,1969,731,10672,2700,5318,1202,2162,29.16%,6.59%,12%,3712,13930,20.35%,79.65%,11258,1852,65,70,0,34,
0500000US48053,"Burnet County, Texas",47548,24001,50.48%,49.52%,57.8,1173,2.47%,1955,1056,244,10239,2029,5816,3195,29779,9011,12194,3085,6060,25.65%,6.49%,13%,11199,37931,23.55%,76.45%,34810,579,183,424,14,147,
0500000US48055,"Caldwell County, Texas",42817,20964,48.96%,51.04%,46.8,3437,8.03%,2475,1202,142,10438,1271,2939,1148,22023,4087,12913,2473,3081,30.16%,5.78%,7%,25468,20415,59.48%,40.52%,16560,2225,129,227,4,178,
0500000US48057,"Calhoun County, Texas",21470,10418,48.52%,51.48%,52.9,672,3.13%,799,627,46,4432,1246,1597,913,11598,2510,5231,1873,1643,24.36%,8.72%,8%,9858,10248,45.92%,54.08%,8374,361,34,1112,0,56,
0500000US48059,"Callahan County, Texas",13959,7051,50.51%,49.49%,53.6,766,5.49%,377,427,42,3473,666,1689,550,8839,2239,3850,1093,1731,27.58%,7.83%,12%,1306,12402,9.36%,90.64%,11555,118,66,52,7,50,
0500000US48061,"Cameron County, Texas",422135,216311,51.24%,48.76%,48.2,47956,11.36%,16450,18638,1830,64940,18068,31264,13882,170501,45146,81390,36706,33094,19.28%,8.70%,8%,376680,44337,89.23%,10.77%,37107,1405,365,2596,80,846,
0500000US48063,"Camp County, Texas",12938,6665,51.52%,48.49%,48.4,1298,10.03%,658,329,59,2820,581,1217,631,7409,1848,3478,910,1276,26.88%,7.03%,10%,3222,9242,24.90%,75.10%,6734,1877,28,105,8,34,
0500000US48065,"Carson County, Texas",5957,3002,50.39%,49.61%,58.2,385,6.46%,173,136,26,1230,320,792,358,3880,1150,1403,456,818,23.55%,7.65%,14%,558,5249,9.37%,90.63%,4873,19,46,19,1,7,
0500000US48067,"Cass County, Texas",30002,15718,52.39%,47.61%,54.6,2093,6.98%,1065,798,68,8944,1443,2667,1171,18216,3838,10009,2241,2735,33.36%,7.47%,9%,1336,27118,4.45%,95.55%,21028,4518,155,119,10,86,
0500000US48069,"Castro County, Texas",7561,3761,49.74%,50.26%,51,590,7.80%,363,176,12,1600,213,577,190,3517,767,1963,389,589,25.96%,5.14%,8%,4784,2587,63.27%,36.73%,2328,95,39,22,4,9,
0500000US48071,"Chambers County, Texas",42571,21151,49.68%,50.32%,59.7,3036,7.13%,1349,1514,410,7166,2872,4017,2048,24212,6065,8515,4386,4427,20.00%,10.30%,10%,10952,35619,25.73%,74.27%,29858,3148,161,622,0,215,
0500000US48073,"Cherokee County, Texas",52341,25578,48.87%,51.13%,53.2,2749,5.25%,2032,1622,143,10798,2706,3949,2024,27707,5973,12830,4328,4092,24.51%,8.27%,8%,11797,38615,22.54%,77.46%,30095,6359,128,263,18,123,
0500000US48075,"Childress County, Texas",7219,2646,36.65%,63.35%,38.7,189,2.62%,309,195,0,1979,272,779,205,4417,984,2288,467,779,31.69%,6.47%,11%,1942,4722,26.90%,73.10%,3852,572,20,51,2,16,
0500000US48077,"Clay County, Texas",10444,5215,49.93%,50.07%,62,523,5.01%,239,338,38,2658,596,1311,490,6935,1801,2897,934,1349,27.74%,8.94%,13%,641,9577,6.14%,93.86%,8941,35,78,50,0,31,
0500000US48079,"Cochran County, Texas",2860,1369,47.87%,52.13%,48.7,342,11.96%,88,67,0,650,147,118,37,1319,155,738,214,118,25.80%,7.48%,4%,1527,1020,53.39%,46.61%,912,62,6,0,0,0,
0500000US48081,"Coke County, Texas",3298,1707,51.76%,48.24%,64.5,110,3.34%,9,56,33,825,124,342,208,2062,550,834,180,375,25.29%,5.46%,11%,661,2624,20.04%,79.96%,2473,7,15,1,6,6,
0500000US48083,"Coleman County, Texas",8281,4018,48.52%,51.48%,56,524,6.33%,172,107,78,2176,380,707,309,5211,1016,2348,487,785,28.35%,5.88%,9%,1192,6492,14.39%,85.61%,6013,142,36,32,0,29,
0500000US48085,"Collin County, Texas",1006038,510490,50.74%,49.26%,58.2,33852,3.36%,25939,34796,13207,95870,49991,223727,128789,621900,352516,121809,84787,236934,12.11%,8.43%,24%,169158,895307,16.81%,83.19%,542472,108100,3874,188365,613,4910,
0500000US48087,"Collingsworth County, Texas",2939,1424,48.45%,51.55%,50.3,256,8.71%,150,46,0,415,139,348,78,1437,426,565,185,348,19.22%,6.29%,12%,832,1820,28.31%,71.69%,1617,108,23,7,1,0,
0500000US48089,"Colorado County, Texas",21357,10805,50.59%,49.41%,49.5,1013,4.74%,695,860,107,5480,1090,2029,715,12131,2744,6175,1950,2136,28.91%,9.13%,10%,5990,14567,28.05%,71.95%,11761,2222,13,80,0,41,
0500000US48091,"Comal County, Texas",148921,75302,50.57%,49.44%,58.4,5309,3.56%,4977,3439,1393,26439,7198,25639,13784,97394,39423,31416,10637,27032,21.10%,7.14%,18%,43590,117911,29.27%,70.73%,105250,3584,514,1844,127,700,
0500000US48093,"Comanche County, Texas",13597,6756,49.69%,50.31%,56,944,6.94%,340,204,122,3175,806,1393,561,8321,1954,3515,1010,1515,25.85%,7.43%,11%,3867,9727,28.44%,71.56%,9197,39,49,38,3,24,
0500000US48095,"Concho County, Texas",3018,1095,36.28%,63.72%,49.1,136,4.51%,26,26,8,729,124,255,60,1653,315,755,150,263,25.02%,4.97%,9%,1033,2270,34.23%,65.77%,2097,69,9,19,1,16,
0500000US48097,"Cooke County, Texas",40428,20380,50.41%,49.59%,56.2,1624,4.02%,1281,1333,116,8473,2362,4048,1934,24019,5982,9754,3695,4164,24.13%,9.14%,10%,8519,33149,21.07%,78.93%,29404,1181,360,307,13,125,
0500000US48099,"Coryell County, Texas",75576,37853,50.09%,49.91%,44.3,2417,3.20%,5405,3982,304,13295,5248,5377,2720,42492,8097,18700,9230,5681,24.74%,12.21%,8%,16482,66611,21.81%,78.19%,46213,11760,414,1816,1041,389,
0500000US48101,"Cottle County, Texas",1624,883,54.37%,45.63%,42.7,160,9.85%,0,52,4,289,80,126,75,864,201,289,132,130,17.80%,8.13%,8%,327,1053,20.14%,79.86%,902,96,2,0,1,0,
0500000US48103,"Crane County, Texas",4739,2288,48.28%,51.72%,56.4,93,1.96%,249,91,0,1046,214,281,99,2195,380,1295,305,281,27.33%,6.44%,6%,3158,1517,66.64%,33.36%,1342,70,14,22,0,1,
0500000US48105,"Crockett County, Texas",3393,1792,52.82%,47.19%,67.8,136,4.01%,104,10,0,1173,80,130,109,1943,239,1277,90,130,37.64%,2.65%,4%,1920,1178,56.59%,43.41%,1080,18,9,10,0,9,
0500000US48107,"Crosby County, Texas",5753,2854,49.61%,50.39%,48.9,466,8.10%,202,207,39,1227,239,424,133,2854,557,1429,446,463,24.84%,7.75%,8%,2829,2304,49.17%,50.83%,2076,117,8,12,0,6,
0500000US48109,"Culberson County, Texas",2183,973,44.57%,55.43%,32.6,153,7.01%,24,107,0,458,62,211,22,926,233,482,169,211,22.08%,7.74%,10%,1645,543,75.36%,24.64%,445,20,11,28,0,3,
0500000US48111,"Dallam County, Texas",7272,3579,49.22%,50.78%,56.4,237,3.26%,265,73,26,1257,89,586,165,3007,751,1522,162,612,20.93%,2.23%,8%,3707,3408,50.98%,49.02%,3119,74,51,10,3,10,
0500000US48113,"Dallas County, Texas",2622634,1329339,50.69%,49.31%,45.1,157957,6.02%,84198,94842,32475,380373,99082,344893,203004,1355206,547897,464571,193924,377368,17.71%,7.39%,14%,1057835,1555704,40.33%,59.67%,724987,564741,6743,181314,1175,9990,
0500000US48115,"Dawson County, Texas",12849,5786,45.03%,54.97%,42.2,863,6.72%,528,319,32,2725,337,942,229,5796,1171,3253,656,974,25.32%,5.11%,8%,6767,5689,52.67%,47.33%,4590,847,23,56,4,17,
0500000US48117,"Deaf Smith County, Texas",18617,9295,49.93%,50.07%,55.1,1156,6.21%,934,554,28,4138,443,934,381,7967,1315,5072,997,962,27.24%,5.36%,5%,13925,4658,74.80%,25.20%,4233,107,47,44,0,40,
0500000US48119,"Delta County, Texas",5277,2909,55.13%,44.87%,57.3,290,5.50%,171,199,21,1221,307,504,275,3151,779,1392,506,525,26.38%,9.59%,10%,394,4836,7.47%,92.53%,4189,312,42,37,5,30,
0500000US48121,"Denton County, Texas",861690,437846,50.81%,49.19%,53.9,31365,3.64%,21793,40984,10067,100267,42502,175253,85276,528191,260529,122060,83486,185320,14.17%,9.69%,22%,182778,723644,21.21%,78.79%,485646,95386,3582,92751,650,3909,
0500000US48123,"DeWitt County, Texas",20217,9694,47.95%,52.05%,51.6,860,4.25%,524,423,30,5720,1149,1309,438,11850,1747,6244,1572,1339,30.88%,7.78%,7%,6890,12934,34.08%,65.92%,10854,1557,32,70,2,35,
0500000US48125,"Dickens County, Texas",2182,1121,51.38%,48.63%,53.8,126,5.77%,64,11,14,541,111,185,117,1301,302,605,122,199,27.73%,5.59%,9%,512,1258,23.46%,76.54%,1178,18,0,1,2,7,
0500000US48127,"Dimmit County, Texas",10232,5329,52.08%,47.92%,42,2005,19.60%,367,135,41,1972,202,522,437,4377,959,2339,337,563,22.86%,3.29%,6%,7487,1128,73.17%,26.83%,898,72,8,68,10,12,
0500000US48129,"Donley County, Texas",3317,1674,50.47%,49.53%,51.3,208,6.27%,102,299,2,650,183,283,116,1974,399,752,482,285,22.67%,14.53%,9%,356,2902,10.73%,89.27%,2537,167,27,10,1,6,
0500000US48131,"Duval County, Texas",11194,5511,49.23%,50.77%,40.5,1008,9.00%,617,290,0,2169,527,382,272,5027,654,2786,817,382,24.89%,7.30%,3%,7962,1869,71.13%,28.87%,937,145,13,45,0,8,
0500000US48133,"Eastland County, Texas",18289,9156,50.06%,49.94%,51.6,1408,7.70%,570,986,88,3898,1201,1511,905,10697,2416,4468,2187,1599,24.43%,11.96%,9%,2934,14791,16.04%,83.96%,13653,335,96,95,16,26,
0500000US48135,"Ector County, Texas",162067,79662,49.15%,50.85%,47.7,10056,6.20%,5791,6490,755,29184,6846,11342,4729,74089,16071,34975,13336,12097,21.58%,8.23%,7%,100051,65120,61.73%,38.27%,51023,7430,568,2257,327,492,
0500000US48137,"Edwards County, Texas",1944,943,48.51%,51.49%,38.5,12,0.62%,141,0,0,374,86,196,41,1000,237,515,86,196,26.49%,4.42%,10%,718,704,36.93%,63.07%,651,2,5,11,1,2,
0500000US48139,"Ellis County, Texas",179484,90884,50.64%,49.36%,56.8,6074,3.38%,5612,6914,692,31740,9109,19952,9321,100273,29273,37352,16023,20644,20.81%,8.93%,12%,52032,140423,28.99%,71.01%,106495,23738,710,1525,202,790,
0500000US48141,"El Paso County, Texas",836915,423844,50.64%,49.36%,45.1,61140,7.31%,29839,48247,7100,119067,45877,82646,40897,405954,123543,148906,94124,89746,17.79%,11.25%,11%,715351,150306,85.47%,14.53%,98219,24415,2365,10692,1527,2422,
0500000US48143,"Erath County, Texas",42226,21733,51.47%,48.53%,47.5,3555,8.42%,2335,5615,721,6367,1729,5459,2638,21413,8097,8702,7344,6180,20.61%,17.39%,15%,9254,33291,21.92%,78.08%,30006,1194,215,348,13,104,
0500000US48145,"Falls County, Texas",17281,9107,52.70%,47.30%,40,1825,10.56%,608,499,45,4260,877,1095,420,9447,1515,4868,1376,1140,28.17%,7.96%,7%,3965,13003,22.94%,77.06%,8707,3708,55,51,8,42,
0500000US48147,"Fannin County, Texas",35046,16474,47.01%,52.99%,52.1,1991,5.68%,1220,1022,136,8867,1441,2999,1414,21052,4413,10087,2463,3135,28.78%,7.03%,9%,4218,31444,12.04%,87.96%,27042,2199,309,145,20,112,
0500000US48149,"Fayette County, Texas",25247,12661,50.15%,49.85%,54.9,928,3.68%,594,778,93,7294,1312,3011,1114,16458,4125,7888,2090,3104,31.24%,8.28%,12%,5216,19219,20.66%,79.34%,17041,1383,50,67,6,72,
0500000US48151,"Fisher County, Texas",3827,1936,50.59%,49.41%,57.5,209,5.46%,78,103,55,962,302,406,149,2430,555,1040,405,461,27.18%,10.58%,12%,973,2699,25.42%,74.58%,2496,92,15,13,2,11,
0500000US48153,"Floyd County, Texas",5782,2943,50.90%,49.10%,57.2,312,5.40%,237,160,7,1121,285,421,172,2843,593,1358,445,428,23.49%,7.70%,7%,3067,2335,53.04%,46.96%,2079,125,7,12,1,13,
0500000US48155,"Foard County, Texas",1207,598,49.54%,50.46%,57.3,67,5.55%,0,101,0,255,92,84,29,719,113,255,193,84,21.13%,15.99%,7%,197,898,16.32%,83.68%,845,19,0,3,1,2,
0500000US48157,"Fort Bend County, Texas",790892,402637,50.91%,49.09%,58.5,29981,3.79%,20181,28058,9126,90661,38204,141155,95149,461452,236304,110842,66262,150281,14.01%,8.38%,19%,198580,624199,25.11%,74.89%,243726,167964,1269,181522,276,4055,
0500000US48159,"Franklin County, Texas",10767,5319,49.40%,50.60%,57.9,539,5.01%,245,338,63,1852,573,1668,579,6719,2247,2097,911,1731,19.48%,8.46%,16%,1455,8904,13.51%,86.49%,7876,394,39,68,6,61,
0500000US48161,"Freestone County, Texas",19744,9456,47.89%,52.11%,49.5,901,4.56%,541,444,168,4414,1372,1485,567,11360,2052,4955,1816,1653,25.10%,9.20%,8%,3155,16280,15.98%,84.02%,12817,2740,64,66,11,46,
0500000US48163,"Frio County, Texas",20013,7818,39.07%,60.94%,34,492,2.46%,1650,286,74,4217,804,528,498,8124,1026,5867,1090,602,29.32%,5.45%,3%,14171,4214,70.81%,29.19%,3053,705,49,199,9,81,
0500000US48165,"Gaines County, Texas",21077,10399,49.34%,50.66%,54.8,1677,7.96%,1154,449,61,3666,581,836,348,7003,1184,4820,1030,897,22.87%,4.89%,4%,8401,13197,39.86%,60.14%,12554,241,42,72,3,46,
0500000US48167,"Galveston County, Texas",337600,171576,50.82%,49.18%,51.5,15310,4.53%,9660,12167,2798,55832,21814,48194,24717,203368,72911,65492,33981,50992,19.40%,10.07%,15%,88636,262046,26.25%,73.75%,191358,43120,1036,12202,223,1455,
0500000US48169,"Garza County, Texas",6028,2222,36.86%,63.14%,47.2,304,5.04%,482,116,72,1385,107,362,181,2870,543,1867,223,434,30.97%,3.70%,7%,3272,2544,54.28%,45.72%,2162,230,28,25,0,10,
0500000US48171,"Gillespie County, Texas",26668,13784,51.69%,48.31%,59.1,1272,4.77%,724,559,170,5869,1211,4666,2021,17564,6687,6593,1770,4836,24.72%,6.64%,18%,5766,20959,21.62%,78.38%,19884,84,69,127,1,100,
0500000US48173,"Glasscock County, Texas",1447,650,44.92%,55.08%,65.4,150,10.37%,52,90,26,213,26,169,69,648,238,265,116,195,18.31%,8.02%,13%,387,729,26.74%,73.26%,710,8,0,0,3,0,
0500000US48175,"Goliad County, Texas",7578,3809,50.26%,49.74%,51.9,264,3.48%,134,349,8,1354,579,633,224,4424,857,1488,928,641,19.64%,12.25%,8%,2288,4724,30.19%,69.81%,4246,235,18,24,0,16,
0500000US48177,"Gonzales County, Texas",20828,10205,49.00%,51.00%,50.6,933,4.48%,944,342,36,5850,662,1157,518,10250,1675,6794,1004,1193,32.62%,4.82%,6%,9897,9756,47.52%,52.48%,8159,1075,41,63,6,45,
0500000US48179,"Gray County, Texas",22063,10363,46.97%,53.03%,50.3,1190,5.39%,959,564,43,4697,1176,1551,656,11652,2207,5656,1740,1594,25.64%,7.89%,7%,6347,14880,28.77%,71.23%,13025,835,141,127,0,37,
0500000US48181,"Grayson County, Texas",133527,68390,51.22%,48.78%,50.6,7040,5.27%,4051,5564,654,27015,9881,12687,5867,80794,18554,31066,15445,13341,23.27%,11.57%,10%,20868,114675,15.63%,84.37%,95211,7448,1876,1958,58,348,
0500000US48183,"Gregg County, Texas",123633,63541,51.40%,48.61%,47.7,8476,6.86%,4521,5538,426,22429,6844,11908,5064,67844,16972,26950,12382,12334,21.80%,10.02%,10%,24040,100199,19.44%,80.56%,68050,24974,424,1614,47,298,
0500000US48185,"Grimes County, Texas",28447,13106,46.07%,53.93%,48.4,1726,6.07%,1008,594,19,6685,1206,2204,1373,15916,3577,7693,1800,2223,27.04%,6.33%,8%,7361,21907,25.88%,74.12%,16910,3824,85,102,8,84,
0500000US48187,"Guadalupe County, Texas",163030,82389,50.54%,49.46%,54.1,6324,3.88%,6689,5019,993,33049,10020,19500,10704,95736,30204,39738,15039,20493,24.37%,9.22%,13%,65233,107473,40.01%,59.99%,84063,11947,476,3066,353,774,
0500000US48189,"Hale County, Texas",33463,15945,47.65%,52.35%,46.6,2147,6.42%,1413,1656,150,6788,1078,2301,1237,15423,3538,8201,2734,2451,24.51%,8.17%,7%,19489,13033,58.24%,41.76%,10693,1381,99,149,30,69,
0500000US48191,"Hall County, Texas",3025,1560,51.57%,48.43%,50.8,225,7.44%,145,84,4,721,163,275,105,1687,380,866,247,279,28.63%,8.17%,9%,950,1875,31.40%,68.60%,1589,190,7,9,0,3,
0500000US48193,"Hamilton County, Texas",8434,4199,49.79%,50.21%,49.4,370,4.39%,375,195,0,2118,379,933,293,5193,1226,2493,574,933,29.56%,6.81%,11%,1045,7177,12.39%,87.61%,6805,32,37,36,2,17,
0500000US48195,"Hansford County, Texas",5431,2647,48.74%,51.26%,56.8,161,2.96%,149,112,46,919,175,682,95,2393,777,1068,287,728,19.66%,5.28%,13%,2615,2670,48.15%,51.85%,2552,12,16,9,3,18,
0500000US48197,"Hardeman County, Texas",3958,2011,50.81%,49.19%,50.7,303,7.66%,89,120,0,874,214,302,167,2345,469,963,334,302,24.33%,8.44%,8%,818,2731,20.67%,79.33%,2441,130,14,18,1,7,
0500000US48199,"Hardin County, Texas",57356,29605,51.62%,48.38%,54.9,3050,5.32%,2180,1310,240,15374,3551,5397,1621,34481,7018,17554,4861,5637,30.61%,8.48%,10%,3417,52814,5.96%,94.04%,46934,3037,190,399,34,149,
0500000US48201,"Harris County, Texas",4680609,2356526,50.35%,49.65%,47.1,309455,6.61%,140708,177602,45612,683675,212930,613469,353123,2451797,966592,824383,390532,659081,17.61%,8.34%,14%,2034709,2696436,43.47%,56.53%,1309593,885517,8432,344762,3199,23262,
0500000US48203,"Harrison County, Texas",66547,34294,51.53%,48.47%,51.8,5385,8.09%,2032,2202,455,14059,3168,6183,2816,38258,8999,16091,5370,6638,24.18%,8.07%,10%,9839,59000,14.79%,85.21%,42039,13448,294,483,28,267,
0500000US48205,"Hartley County, Texas",5588,2207,39.50%,60.51%,49.8,153,2.74%,89,35,104,1564,144,491,380,3473,871,1653,179,595,29.58%,3.20%,11%,1631,3751,29.19%,70.81%,3403,191,15,24,5,1,
0500000US48207,"Haskell County, Texas",5711,2665,46.66%,53.34%,50.9,415,7.27%,184,124,31,1345,217,389,276,2960,665,1529,341,420,26.77%,5.97%,7%,1377,4039,24.11%,75.89%,3628,181,28,22,5,24,
0500000US48209,"Hays County, Texas",222827,112108,50.31%,49.69%,47.8,13309,5.97%,11350,19750,3485,30680,8018,33431,18424,121470,51855,42030,27768,36916,18.86%,12.46%,17%,92871,148196,41.68%,58.32%,121568,9004,599,4822,144,1009,
0500000US48211,"Hemphill County, Texas",3901,1765,45.25%,54.76%,57.7,155,3.97%,112,193,0,879,134,392,105,1980,497,991,327,392,25.40%,8.38%,10%,1137,2245,29.15%,70.85%,2090,4,18,10,0,4,
0500000US48213,"Henderson County, Texas",81969,41728,50.91%,49.09%,53.7,5716,6.97%,2355,2448,339,19424,4300,6747,3871,49227,10618,21779,6748,7086,26.57%,8.23%,9%,11242,70908,13.71%,86.29%,61854,4705,414,510,31,211,
0500000US48215,"Hidalgo County, Texas",861137,439208,51.00%,49.00%,48.2,108325,12.58%,28167,43667,5721,115900,24439,64879,28857,325021,93736,144067,68106,70600,16.73%,7.91%,8%,800001,70780,92.90%,7.10%,53338,3364,635,8604,78,1915,
0500000US48217,"Hill County, Texas",36109,18045,49.97%,50.03%,53.6,1385,3.84%,1019,1487,54,8456,2155,2987,1339,20880,4326,9475,3642,3041,26.24%,10.09%,8%,7884,27990,21.83%,78.17%,24123,2055,137,188,15,87,
0500000US48219,"Hockley County, Texas",22986,11531,50.17%,49.84%,52.5,1525,6.63%,902,1164,149,4052,1315,1561,689,10866,2250,4954,2479,1710,21.55%,10.78%,7%,10624,10913,46.22%,53.78%,9752,565,82,49,4,59,
0500000US48221,"Hood County, Texas",60025,30787,51.29%,48.71%,63,1851,3.08%,1590,1335,457,12813,2983,8561,4148,39512,12709,14403,4318,9018,24.00%,7.19%,15%,7958,53640,13.26%,86.74%,49815,495,340,468,53,180,
0500000US48223,"Hopkins County, Texas",36708,18683,50.90%,49.10%,55.1,1591,4.33%,1156,1152,248,8468,1769,3708,1546,20937,5254,9624,2921,3956,26.22%,7.96%,11%,6484,30303,17.66%,82.34%,25976,2373,198,277,4,85,
0500000US48225,"Houston County, Texas",22942,10556,46.01%,53.99%,44,1590,6.93%,628,570,63,6122,1237,1850,772,13669,2622,6750,1807,1913,29.42%,7.88%,8%,3071,18995,13.39%,86.61%,12957,5163,94,138,8,58,
0500000US48227,"Howard County, Texas",36213,15836,43.73%,56.27%,43.3,2579,7.12%,1252,1138,50,8590,1582,2263,1051,19842,3314,9842,2720,2313,27.18%,7.51%,6%,16174,18686,44.66%,55.34%,15672,1520,211,386,12,68,
0500000US48229,"Hudspeth County, Texas",4687,2297,49.01%,50.99%,44.8,331,7.06%,89,225,0,976,166,297,11,1761,308,1065,391,297,22.72%,8.34%,6%,2036,1166,43.44%,56.56%,1094,6,6,10,0,7,
0500000US48231,"Hunt County, Texas",96202,49017,50.95%,49.05%,50.5,6161,6.40%,3392,4449,784,21980,4479,8547,4409,54379,12956,25372,8928,9331,26.37%,9.28%,10%,19673,80283,20.45%,79.55%,65598,7812,722,979,151,301,
0500000US48233,"Hutchinson County, Texas",21105,10317,48.88%,51.12%,48.1,1251,5.93%,696,766,87,4700,1185,1646,503,12023,2149,5396,1951,1733,25.57%,9.24%,8%,4961,15656,23.51%,76.49%,13783,416,273,105,2,52,
0500000US48235,"Irion County, Texas",1553,753,48.49%,51.51%,61.4,139,8.95%,40,67,0,413,102,173,46,1005,219,453,169,173,29.17%,10.88%,11%,349,1164,22.47%,77.53%,1112,6,9,0,1,1,
0500000US48237,"Jack County, Texas",8888,3798,42.73%,57.27%,51.7,582,6.55%,345,166,11,2353,422,565,329,5003,894,2698,588,576,30.36%,6.62%,6%,1521,6951,17.11%,82.89%,6358,294,35,41,5,9,
0500000US48239,"Jackson County, Texas",14822,7621,51.42%,48.58%,56,685,4.62%,506,444,111,3291,631,1135,394,8087,1529,3797,1075,1246,25.62%,7.25%,8%,4829,10159,32.58%,67.42%,8510,937,36,158,5,102,
0500000US48241,"Jasper County, Texas",35562,17986,50.58%,49.42%,50,2514,7.07%,1501,706,69,10920,1802,1916,1325,20693,3241,12421,2508,1985,34.93%,7.05%,6%,2198,30782,6.18%,93.82%,23795,5572,127,114,16,72,
0500000US48243,"Jeff Davis County, Texas",2245,1075,47.88%,52.12%,54.4,289,12.87%,124,116,6,256,121,237,260,1341,497,380,237,243,16.93%,10.56%,11%,613,1383,27.31%,72.69%,1282,0,6,14,0,15,
0500000US48245,"Jefferson County, Texas",253136,123680,48.86%,51.14%,45.2,21783,8.61%,8801,10085,1572,54032,13771,21766,10658,141274,32424,62833,23856,23338,24.82%,9.42%,9%,58915,197611,23.27%,76.73%,96047,83856,622,9943,66,867,
0500000US48247,"Jim Hogg County, Texas",5187,2484,47.89%,52.11%,43.2,600,11.57%,141,145,0,1166,109,277,97,2108,374,1307,254,277,25.20%,4.90%,5%,4281,557,82.53%,17.47%,414,5,15,26,5,8,
0500000US48249,"Jim Wells County, Texas",40796,20563,50.40%,49.60%,48.2,4962,12.16%,1161,1445,22,9101,1476,3247,931,20199,4178,10262,2921,3269,25.15%,7.16%,8%,30835,8056,75.58%,24.42%,6963,180,58,140,15,95,
0500000US48251,"Johnson County, Texas",171359,85784,50.06%,49.94%,55.4,8593,5.01%,7125,4358,1076,40122,7913,15089,6780,96083,21869,47247,12271,16165,27.57%,7.16%,9%,42613,137314,24.87%,75.13%,119226,6446,840,1726,929,612,
0500000US48253,"Jones County, Texas",19874,7452,37.50%,62.50%,43.5,588,2.96%,672,174,0,5661,957,1365,393,11718,1758,6333,1131,1365,31.87%,5.69%,7%,5504,14159,27.69%,72.31%,11485,1978,66,111,4,41,
0500000US48255,"Karnes County, Texas",15547,6373,40.99%,59.01%,43.4,1344,8.64%,558,478,140,3824,545,1190,485,7982,1675,4382,1023,1330,28.19%,6.58%,9%,7734,6976,49.75%,50.25%,5388,1116,26,145,1,61,
0500000US48257,"Kaufman County, Texas",129792,65923,50.79%,49.21%,52.3,6530,5.03%,4315,3692,1022,27442,7160,11771,4974,71212,16745,31757,10852,12793,24.47%,8.36%,10%,36165,109145,27.86%,72.14%,78626,21541,623,2107,70,435,
0500000US48259,"Kendall County, Texas",45491,23181,50.96%,49.04%,58.2,1378,3.03%,1585,996,367,5983,2481,8944,5161,29309,14105,7568,3477,9311,16.64%,7.64%,20%,10029,34250,22.05%,77.95%,31767,315,138,355,36,202,
0500000US48261,"Kenedy County, Texas",391,198,50.64%,49.36%,51.5,3,0.77%,0,0,0,39,0,1,3,59,4,39,0,1,9.97%,0.00%,0%,261,89,66.75%,33.25%,73,0,7,0,1,2,
0500000US48263,"Kent County, Texas",704,383,54.40%,45.60%,55.6,12,1.70%,17,0,0,123,39,88,69,447,157,140,39,88,19.89%,5.54%,13%,81,672,11.51%,88.49%,657,2,3,0,0,3,
0500000US48265,"Kerr County, Texas",52195,26918,51.57%,48.43%,52.5,2842,5.44%,1991,1590,120,10714,2731,6890,3797,33868,10687,12705,4321,7010,24.34%,8.28%,13%,13598,39000,26.05%,73.95%,35791,690,156,576,39,187,
0500000US48267,"Kimble County, Texas",4375,2333,53.33%,46.67%,53.4,301,6.88%,174,17,16,1015,174,506,313,2773,819,1189,191,522,27.18%,4.37%,12%,986,3300,22.54%,77.46%,3136,8,14,33,3,8,
0500000US48269,"King County, Texas",279,123,44.09%,55.91%,48.5,101,36.20%,0,0,2,114,2,22,8,174,30,114,2,24,40.86%,0.72%,9%,25,240,8.96%,91.04%,230,0,0,0,4,0,
0500000US48271,"Kinney County, Texas",3674,1487,40.47%,59.53%,45.7,192,5.23%,156,129,0,803,197,372,169,2335,541,959,326,372,26.10%,8.87%,10%,1470,1659,40.01%,59.99%,1489,36,21,10,2,15,
0500000US48273,"Kleberg County, Texas",30725,15213,49.51%,50.49%,42.5,4192,13.64%,1057,3779,864,4727,735,2919,1217,13455,4136,5784,4514,3783,18.83%,14.69%,12%,21920,9120,71.34%,28.66%,6728,995,83,784,1,97,
0500000US48275,"Knox County, Texas",3679,1862,50.61%,49.39%,55.2,142,3.86%,114,63,21,754,171,287,177,1986,464,868,234,308,23.59%,6.36%,8%,1130,2223,30.71%,69.29%,1935,146,8,24,3,5,
0500000US48277,"Lamar County, Texas",49705,25932,52.17%,47.83%,49.7,4817,9.69%,1689,1203,345,11443,2989,4375,2031,29420,6406,13132,4192,4720,26.42%,8.43%,9%,4412,45676,8.88%,91.12%,35354,6378,751,474,25,119,
0500000US48279,"Lamb County, Texas",13018,6545,50.28%,49.72%,47.6,1065,8.18%,297,626,7,2895,639,809,228,6260,1037,3192,1265,816,24.52%,9.72%,6%,7449,5596,57.22%,42.78%,4981,392,15,4,5,24,
0500000US48281,"Lampasas County, Texas",21152,10323,48.80%,51.20%,56.5,943,4.46%,944,426,52,4381,1978,1848,909,13445,2757,5325,2404,1900,25.17%,11.37%,9%,4179,17448,19.76%,80.24%,15132,700,115,242,86,100,
0500000US48283,"La Salle County, Texas",7551,3139,41.57%,58.43%,43.3,547,7.24%,293,387,40,2280,79,305,41,3321,346,2573,466,345,34.07%,6.17%,5%,4908,1756,65.00%,35.00%,1467,221,3,4,0,5,
0500000US48285,"Lavaca County, Texas",20072,10305,51.34%,48.66%,55.8,803,4.00%,499,664,80,5649,1097,1845,634,11963,2479,6148,1761,1925,30.63%,8.77%,10%,3936,16401,19.61%,80.39%,14564,1173,30,74,5,31,
0500000US48287,"Lee County, Texas",17174,8733,50.85%,49.15%,54.6,963,5.61%,602,461,97,4401,829,1135,546,9984,1681,5003,1290,1232,29.13%,7.51%,7%,4479,12999,26.08%,73.92%,10612,1631,47,57,1,37,
0500000US48289,"Leon County, Texas",17325,8744,50.47%,49.53%,58.5,892,5.15%,398,372,22,4837,656,1396,462,10149,1858,5235,1028,1418,30.22%,5.93%,8%,2446,13273,14.12%,85.88%,11659,921,54,111,6,47,
0500000US48291,"Liberty County, Texas",86173,43690,50.70%,49.30%,49.5,4693,5.45%,3613,2300,437,21682,3223,3955,1531,43439,5486,25295,5523,4392,29.35%,6.41%,5%,30797,60831,35.74%,64.26%,50044,7024,291,466,12,329,
0500000US48293,"Limestone County, Texas",23364,11398,48.78%,51.22%,47.6,1787,7.65%,885,573,49,5718,1070,1900,804,13491,2704,6603,1643,1949,28.26%,7.03%,8%,5013,17133,21.46%,78.54%,12530,3636,72,160,18,60,
0500000US48295,"Lipscomb County, Texas",3301,1753,53.11%,46.90%,57.9,215,6.51%,78,135,14,618,135,368,121,1710,489,696,270,382,21.08%,8.18%,12%,1123,1936,34.02%,65.98%,1786,4,29,2,0,4,
0500000US48297,"Live Oak County, Texas",12175,5519,45.33%,54.67%,45.4,699,5.74%,532,258,3,3081,424,607,351,6705,958,3613,682,610,29.68%,5.60%,5%,4790,6545,39.34%,60.66%,5968,205,49,35,3,45,
0500000US48299,"Llano County, Texas",21452,10894,50.78%,49.22%,54.6,728,3.39%,401,403,11,4597,1216,3169,1271,14828,4440,4998,1619,3180,23.30%,7.55%,15%,2508,18735,11.69%,88.31%,17530,97,115,121,4,61,
0500000US48301,"Loving County, Texas",117,34,29.06%,70.94%,37.4,0,0.00%,3,0,0,13,48,0,0,85,0,16,48,0,13.68%,41.03%,0%,1,63,0.85%,99.15%,56,0,1,0,0,1,
0500000US48303,"Lubbock County, Texas",308392,156490,50.74%,49.26%,43.4,27659,8.97%,14150,28078,6381,45903,12102,36555,21962,159397,58517,60053,40180,42936,19.47%,13.03%,14%,109170,201469,35.40%,64.60%,154994,25663,1436,9490,180,968,
0500000US48305,"Lynn County, Texas",5886,2857,48.54%,51.46%,59,351,5.96%,198,119,28,1144,275,582,223,3055,805,1342,394,610,22.80%,6.69%,10%,2352,3244,39.96%,60.04%,2960,105,15,10,4,12,
0500000US48307,"McCulloch County, Texas",7970,3802,47.70%,52.30%,45.5,436,5.47%,422,94,19,1746,321,621,363,4476,984,2168,415,640,27.20%,5.21%,8%,2369,5261,29.72%,70.28%,4904,92,7,39,0,12,
0500000US48309,"McLennan County, Texas",254045,130061,51.20%,48.80%,44.5,20408,8.03%,10888,19033,3433,42807,15575,24558,14174,132209,38732,53695,34608,27991,21.14%,13.62%,11%,68587,191992,27.00%,73.00%,139693,36130,901,4873,146,1065,
0500000US48311,"McMullen County, Texas",724,390,53.87%,46.13%,61.7,13,1.80%,21,28,0,210,33,47,21,409,68,231,61,47,31.91%,8.43%,6%,224,376,30.94%,69.06%,353,1,1,3,5,0,
0500000US48313,"Madison County, Texas",14329,6148,42.91%,57.09%,47.1,368,2.57%,765,284,40,3828,610,940,422,7996,1362,4593,894,980,32.05%,6.24%,7%,3415,10040,23.83%,76.17%,6984,2587,48,101,0,11,
0500000US48315,"Marion County, Texas",9987,5159,51.66%,48.34%,51.4,737,7.38%,400,199,46,2953,549,980,258,6392,1238,3353,748,1026,33.57%,7.49%,10%,389,9336,3.90%,96.10%,6869,1846,69,48,0,45,
0500000US48317,"Martin County, Texas",5676,2773,48.86%,51.15%,60.7,113,1.99%,276,202,49,1101,129,370,255,2543,625,1377,331,419,24.26%,5.83%,7%,2255,2982,39.73%,60.27%,2780,81,22,9,1,19,
0500000US48319,"Mason County, Texas",4248,2159,50.82%,49.18%,61.2,97,2.28%,105,154,22,535,142,700,310,2463,1010,640,296,722,15.07%,6.97%,17%,883,3070,20.79%,79.21%,2948,4,0,2,0,16,
0500000US48321,"Matagorda County, Texas",36791,18416,50.06%,49.94%,53.4,3373,9.17%,1267,1308,58,7201,1828,3112,1594,19778,4706,8468,3136,3170,23.02%,8.52%,9%,15455,20800,42.01%,57.99%,15355,3734,99,700,7,103,
0500000US48323,"Maverick County, Texas",58098,29223,50.30%,49.70%,48.8,5925,10.20%,2218,2500,372,7943,2032,3978,1203,20337,5181,10161,4532,4350,17.49%,7.80%,7%,54936,2951,94.56%,5.44%,1574,129,835,182,4,110,
0500000US48325,"Medina County, Texas",50869,24597,48.35%,51.65%,51.3,2194,4.31%,1936,1384,425,10838,2846,4294,2630,28789,6924,12774,4230,4719,25.11%,8.32%,9%,25455,25293,50.04%,49.96%,22324,1252,158,215,38,188,
0500000US48327,"Menard County, Texas",2108,949,45.02%,54.98%,51.4,121,5.74%,38,5,11,495,147,253,193,1394,446,533,152,264,25.28%,7.21%,13%,662,1300,31.40%,68.60%,1231,12,7,5,3,8,
0500000US48329,"Midland County, Texas",171238,84695,49.46%,50.54%,50.4,7341,4.29%,5545,5738,1302,27902,8625,21220,8128,89953,29348,33447,14363,22522,19.53%,8.39%,13%,73331,96652,42.82%,57.18%,76487,10465,686,3891,152,621,
0500000US48331,"Milam County, Texas",24797,12657,51.04%,48.96%,50.7,1337,5.39%,865,642,125,6565,1349,1742,784,13963,2526,7430,1991,1867,29.96%,8.03%,8%,6264,18490,25.26%,74.74%,15367,2097,67,111,11,84,
0500000US48333,"Mills County, Texas",4877,2446,50.15%,49.85%,53.2,191,3.92%,196,66,3,1214,224,557,207,3000,764,1410,290,560,28.91%,5.95%,11%,728,3728,14.93%,85.07%,3498,25,10,4,0,6,
0500000US48335,"Mitchell County, Texas",8256,3251,39.38%,60.62%,40.3,150,1.82%,647,129,34,2360,274,481,154,4433,635,3007,403,515,36.42%,4.88%,6%,3454,5536,41.84%,58.16%,4328,925,34,54,1,11,
0500000US48337,"Montague County, Texas",19640,10175,51.81%,48.19%,62.1,1356,6.90%,569,485,43,4962,1248,1701,722,12043,2423,5531,1733,1744,28.16%,8.82%,9%,2361,17604,12.02%,87.98%,16342,73,155,84,4,34,
0500000US48339,"Montgomery County, Texas",590188,298062,50.50%,49.50%,57.9,20899,3.54%,16239,18126,5101,90126,29542,90468,44375,344494,134843,106365,47668,95569,18.02%,8.08%,16%,164089,456354,27.80%,72.20%,371403,34177,1884,21436,634,2522,
0500000US48341,"Moore County, Texas",21169,10004,47.26%,52.74%,57.9,675,3.19%,860,456,152,3358,856,1162,605,8113,1767,4218,1312,1314,19.93%,6.20%,6%,12647,8711,59.74%,40.26%,6499,654,97,982,1,83,
0500000US48343,"Morris County, Texas",12357,6377,51.61%,48.39%,55.8,447,3.62%,358,461,7,3685,627,870,336,7777,1206,4043,1088,877,32.72%,8.80%,7%,1182,10791,9.57%,90.43%,7716,2448,70,35,9,30,
0500000US48345,"Motley County, Texas",1362,655,48.09%,51.91%,53.3,28,2.06%,31,27,0,369,63,138,30,890,168,400,90,138,29.37%,6.61%,10%,153,910,11.23%,88.77%,858,7,0,0,0,2,
0500000US48347,"Nacogdoches County, Texas",65080,33894,52.08%,47.92%,44.6,7100,10.91%,2592,7943,983,10863,2199,5735,3470,31528,9205,13455,10142,6718,20.67%,15.58%,10%,13597,51056,20.89%,79.11%,37158,10567,191,760,10,190,
0500000US48349,"Navarro County, Texas",49475,25187,50.91%,49.09%,54.8,2661,5.38%,1967,1549,163,9677,3033,3534,1928,25724,5462,11644,4582,3697,23.54%,9.26%,7%,16049,36575,32.44%,67.56%,26996,6286,163,393,734,137,
0500000US48351,"Newton County, Texas",13788,6690,48.52%,51.48%,55.1,1253,9.09%,527,226,0,4230,705,700,165,7993,865,4757,931,700,34.50%,6.75%,5%,344,11873,2.49%,97.51%,9249,2075,59,24,0,27,
0500000US48353,"Nolan County, Texas",14901,7231,48.53%,51.47%,50.3,1110,7.45%,535,405,61,3298,864,1024,414,7887,1438,3833,1269,1085,25.72%,8.52%,7%,5354,9384,35.93%,64.07%,8138,625,53,103,2,31,
0500000US48355,"Nueces County, Texas",362151,183227,50.59%,49.41%,45.3,23277,6.43%,13103,16185,2139,69309,20777,33044,18326,198578,51370,82412,36962,35183,22.76%,10.21%,10%,217052,136126,59.93%,40.07%,106165,12651,907,7712,281,1264,
0500000US48357,"Ochiltree County, Texas",9907,5021,50.68%,49.32%,57.1,311,3.14%,287,453,93,1916,334,708,256,4291,964,2203,787,801,22.24%,7.94%,8%,5470,4545,55.21%,44.79%,4245,14,31,28,2,21,
0500000US48359,"Oldham County, Texas",2110,902,42.75%,57.25%,56.2,66,3.13%,27,38,1,385,126,262,72,1142,334,412,164,263,19.53%,7.77%,12%,313,1445,14.83%,85.17%,1325,33,6,10,0,0,
0500000US48361,"Orange County, Texas",83776,42290,50.48%,49.52%,53.5,5387,6.43%,2753,2491,343,20647,5736,6979,1990,49572,8969,23400,8227,7322,27.93%,9.82%,9%,7265,77543,8.67%,91.33%,64935,7981,343,1108,13,196,
0500000US48363,"Palo Pinto County, Texas",28792,14712,51.10%,48.90%,48.7,1789,6.21%,1134,475,233,6975,1531,2368,1197,17297,3565,8109,2006,2601,28.16%,6.97%,9%,5614,22795,19.50%,80.50%,20778,552,149,211,12,69,
0500000US48365,"Panola County, Texas",23186,11825,51.00%,49.00%,53.2,1506,6.50%,693,986,68,4905,1375,1819,630,13224,2449,5598,2361,1887,24.14%,10.18%,8%,2190,20301,9.45%,90.55%,16098,3244,96,99,7,26,
0500000US48367,"Parker County, Texas",138447,69443,50.16%,49.84%,58.6,4513,3.26%,4135,4065,964,26246,9753,16148,8786,83128,24934,30381,13818,17112,21.94%,9.98%,12%,19819,128403,14.32%,85.68%,117747,1636,878,990,97,470,
0500000US48369,"Parmer County, Texas",9639,4756,49.34%,50.66%,58.6,410,4.25%,360,294,15,1828,569,674,237,4477,911,2188,863,689,22.70%,8.95%,7%,6504,3365,67.48%,32.52%,3187,53,11,14,0,39,
0500000US48371,"Pecos County, Texas",15725,6804,43.27%,56.73%,43.3,1018,6.47%,615,384,35,3780,399,782,436,7642,1218,4395,783,817,27.95%,4.98%,5%,10845,4348,68.97%,31.03%,3473,505,33,143,0,35,
0500000US48373,"Polk County, Texas",50155,23192,46.24%,53.76%,50.1,3762,7.50%,1488,1308,173,13563,2443,3790,1399,29698,5189,15051,3751,3963,30.01%,7.48%,8%,7345,42778,14.64%,85.36%,34808,4869,914,340,0,135,
0500000US48375,"Potter County, Texas",118323,57360,48.48%,51.52%,46.5,8719,7.37%,4671,3863,452,24408,5659,7989,3562,57976,11551,29079,9522,8441,24.58%,8.05%,7%,45193,73332,38.19%,61.81%,50153,11999,636,6036,20,613,
0500000US48377,"Presidio County, Texas",6808,3457,50.78%,49.22%,55.1,663,9.74%,186,203,1,481,358,648,214,2147,862,667,561,649,9.80%,8.24%,10%,4991,1140,73.31%,26.69%,961,25,16,85,0,9,
0500000US48379,"Rains County, Texas",12001,5913,49.27%,50.73%,54.8,558,4.65%,381,204,11,3380,704,959,413,7447,1372,3761,908,970,31.34%,7.57%,8%,1109,11055,9.24%,90.76%,10130,264,85,55,1,33,
0500000US48381,"Randall County, Texas",136005,69242,50.91%,49.09%,53.3,5114,3.76%,4337,6444,1238,21780,8751,18910,8882,83554,27792,26117,15195,20148,19.20%,11.17%,15%,31583,109170,23.22%,76.78%,95457,4567,794,2604,54,412,
0500000US48383,"Reagan County, Texas",3766,1705,45.27%,54.73%,58.3,117,3.11%,249,100,10,957,106,167,92,1836,259,1206,206,177,32.02%,5.47%,5%,2283,1102,60.62%,39.38%,968,33,12,19,1,6,
0500000US48385,"Real County, Texas",3429,1889,55.09%,44.91%,45.3,257,7.49%,65,94,8,851,251,271,134,2121,405,916,345,279,26.71%,10.06%,8%,692,2066,20.18%,79.82%,1940,22,8,12,3,2,
0500000US48387,"Red River County, Texas",12115,6385,52.70%,47.30%,51.5,1016,8.39%,355,218,54,3545,680,1023,384,7987,1407,3900,898,1077,32.19%,7.41%,9%,766,10821,6.32%,93.68%,8499,1738,102,51,0,13,
0500000US48389,"Reeves County, Texas",15546,5988,38.52%,61.48%,37.5,1117,7.19%,552,869,28,3741,600,778,313,7171,1091,4293,1469,806,27.61%,9.45%,5%,12510,2238,80.47%,19.53%,1697,224,27,165,3,39,
0500000US48391,"Refugio County, Texas",7015,3648,52.00%,48.00%,42.9,535,7.63%,191,241,0,1984,454,385,151,3999,536,2175,695,385,31.00%,9.91%,5%,3306,3435,47.13%,52.87%,2864,400,18,27,0,12,
0500000US48393,"Roberts County, Texas",784,384,48.98%,51.02%,67.2,31,3.95%,25,2,5,188,61,91,44,523,135,213,63,96,27.17%,8.04%,12%,50,777,6.38%,93.62%,717,2,2,0,0,1,
0500000US48395,"Robertson County, Texas",17094,8757,51.23%,48.77%,52.6,890,5.21%,664,387,7,4356,889,1493,655,9872,2148,5020,1276,1500,29.37%,7.46%,9%,3528,13229,20.64%,79.36%,9505,3095,29,104,21,37,
0500000US48397,"Rockwall County, Texas",101175,51284,50.69%,49.31%,63.3,1441,1.42%,2474,3547,834,11553,6137,17738,10454,61199,28192,14027,9684,18572,13.86%,9.57%,18%,20560,87259,20.32%,79.68%,70198,8179,479,3306,75,344,
0500000US48399,"Runnels County, Texas",10280,5092,49.53%,50.47%,53.5,554,5.39%,314,363,15,2466,528,926,241,5697,1167,2780,891,941,27.04%,8.67%,9%,3354,6546,32.63%,67.37%,6062,132,39,24,6,15,
0500000US48401,"Rusk County, Texas",53988,25172,46.63%,53.38%,49.2,2991,5.54%,1922,1918,88,11963,3485,3858,2067,30695,5925,13885,5403,3946,25.72%,10.01%,7%,9579,42635,17.74%,82.26%,32022,8240,195,231,18,162,
0500000US48403,"Sabine County, Texas",10470,5471,52.25%,47.75%,57.8,919,8.78%,291,133,14,2794,646,817,562,6811,1379,3085,779,831,29.47%,7.44%,8%,393,9501,3.75%,96.25%,8307,734,51,52,0,35,
0500000US48405,"San Augustine County, Texas",8260,4162,50.39%,49.61%,57.8,1014,12.28%,102,156,0,2575,257,558,302,5051,860,2677,413,558,32.41%,5.00%,7%,639,7279,7.74%,92.26%,5270,1768,19,36,0,0,
0500000US48407,"San Jacinto County, Texas",28574,14511,50.78%,49.22%,54.2,1270,4.44%,1026,389,5,8767,1063,2061,1065,17621,3126,9793,1452,2066,34.27%,5.08%,7%,4822,22580,16.88%,83.12%,19170,2083,123,86,15,74,
0500000US48409,"San Patricio County, Texas",66969,33063,49.37%,50.63%,48,4228,6.31%,2943,1694,243,14089,3281,4637,2194,35012,6831,17032,4975,4880,25.43%,7.43%,7%,38220,30535,57.07%,42.93%,26613,994,198,845,66,227,
0500000US48411,"San Saba County, Texas",6004,2962,49.33%,50.67%,51.2,380,6.33%,308,96,5,1552,176,600,129,3392,729,1860,272,605,30.98%,4.53%,10%,1749,3981,29.13%,70.87%,3690,106,29,16,1,10,
0500000US48413,"Schleicher County, Texas",2898,1422,49.07%,50.93%,58.2,272,9.39%,60,50,40,542,117,251,58,1523,309,602,167,291,20.77%,5.76%,10%,1275,1176,44.00%,56.00%,1102,15,4,7,2,10,
0500000US48415,"Scurry County, Texas",16918,7568,44.73%,55.27%,50.3,358,2.12%,666,410,14,3700,747,1290,517,8994,1807,4366,1157,1304,25.81%,6.84%,8%,7139,9793,42.20%,57.80%,8637,599,60,82,5,27,
0500000US48417,"Shackelford County, Texas",3291,1587,48.22%,51.78%,55.3,218,6.62%,51,113,0,463,112,524,213,1989,737,514,225,524,15.62%,6.84%,16%,363,2742,11.03%,88.97%,2612,20,6,14,0,2,
0500000US48419,"Shelby County, Texas",25263,12805,50.69%,49.31%,51.9,2764,10.94%,995,619,75,5679,920,1699,606,12826,2305,6674,1539,1774,26.42%,6.09%,7%,4685,19337,18.54%,81.46%,14416,3805,50,364,14,49,
0500000US48421,"Sherman County, Texas",3046,1456,47.80%,52.20%,63.3,124,4.07%,71,123,14,502,177,300,77,1518,377,573,300,314,18.81%,9.85%,10%,1315,1467,43.17%,56.83%,1362,10,5,2,0,6,
0500000US48423,"Smith County, Texas",230184,119082,51.73%,48.27%,50.6,14226,6.18%,6487,11189,1362,35547,14877,27612,13281,131720,40893,42034,26066,28974,18.26%,11.32%,13%,47281,186198,20.54%,79.46%,134452,38003,746,4129,77,695,
0500000US48425,"Somervell County, Texas",8958,4444,49.61%,50.39%,53.5,448,5.00%,409,193,13,2178,410,1326,487,5767,1813,2587,603,1339,28.88%,6.73%,15%,1687,7518,18.83%,81.17%,7011,39,49,55,0,33,
0500000US48427,"Starr County, Texas",64032,32846,51.30%,48.70%,42.7,8167,12.75%,2176,3263,517,9456,1298,2729,1173,20549,3902,11632,4561,3246,18.17%,7.12%,5%,64393,1527,100.56%,-0.56%,1171,31,8,100,0,98,
0500000US48429,"Stephens County, Texas",9358,4469,47.76%,52.24%,47.2,713,7.62%,464,159,53,2094,426,771,229,5068,1000,2558,585,824,27.33%,6.25%,9%,2204,6897,23.55%,76.45%,6256,237,36,60,1,27,
0500000US48431,"Sterling County, Texas",1274,643,50.47%,49.53%,60.7,4,0.31%,60,62,0,371,19,83,57,679,140,431,81,83,33.83%,6.36%,7%,449,923,35.24%,64.76%,867,3,4,1,2,2,
0500000US48433,"Stonewall County, Texas",1412,746,52.83%,47.17%,59.7,68,4.82%,60,65,9,353,16,81,29,719,110,413,81,90,29.25%,5.74%,6%,226,1019,16.01%,83.99%,958,18,3,5,0,2,
0500000US48435,"Sutton County, Texas",3793,1805,47.59%,52.41%,64,356,9.39%,107,113,0,804,129,289,164,1859,453,911,242,289,24.02%,6.38%,8%,2093,1279,55.18%,44.82%,1200,6,5,6,0,14,
0500000US48437,"Swisher County, Texas",7403,3391,45.81%,54.19%,45.9,639,8.63%,327,108,110,1723,198,587,193,3686,780,2050,306,697,27.69%,4.13%,9%,3147,3824,42.51%,57.49%,3219,407,18,10,0,8,
0500000US48439,"Tarrant County, Texas",2077153,1061673,51.11%,48.89%,48.9,99470,4.79%,65782,80654,20650,319800,105192,289302,146527,1156056,435829,385582,185846,309952,18.56%,8.95%,15%,620907,1489733,29.89%,70.11%,904884,358645,7033,127783,4147,8321,
0500000US48441,"Taylor County, Texas",137521,70483,51.25%,48.75%,48.1,7837,5.70%,6509,9422,1512,25733,7189,14479,8118,75388,22597,32242,16611,15991,23.45%,12.08%,12%,34756,108452,25.27%,74.73%,87316,10980,589,2815,161,468,
0500000US48443,"Terrell County, Texas",903,428,47.40%,52.60%,51.8,6,0.66%,7,0,0,175,23,149,27,664,176,182,23,149,20.16%,2.55%,17%,370,390,40.97%,59.03%,352,8,0,5,0,2,
0500000US48445,"Terry County, Texas",12408,5826,46.95%,53.05%,49.2,635,5.12%,473,405,10,2369,311,660,245,5457,905,2842,716,670,22.90%,5.77%,5%,6569,5262,52.94%,47.06%,4599,389,29,37,0,24,
0500000US48447,"Throckmorton County, Texas",1500,809,53.93%,46.07%,60.3,115,7.67%,63,50,0,399,78,156,82,928,238,462,128,156,30.80%,8.53%,10%,145,1295,9.67%,90.33%,1248,1,3,3,0,0,
0500000US48449,"Titus County, Texas",32709,16596,50.74%,49.26%,54.7,1590,4.86%,1509,1117,108,7086,1648,2429,920,15623,3349,8595,2765,2537,26.28%,8.45%,8%,13680,17567,41.82%,58.18%,13410,2884,101,262,3,73,
0500000US48451,"Tom Green County, Texas",118645,59396,50.06%,49.94%,46.6,5902,4.97%,4292,7733,936,22156,5557,12726,6333,65850,19059,26448,13290,13662,22.29%,11.20%,12%,47066,72937,39.67%,60.33%,62390,4010,366,1704,143,369,
0500000US48453,"Travis County, Texas",1250884,619098,49.49%,50.51%,45.2,70599,5.64%,26768,54619,21790,136213,47111,280975,165271,781592,446246,162981,101730,302765,13.03%,8.13%,24%,421110,869078,33.66%,66.34%,612824,96270,2762,99660,774,6513,
0500000US48455,"Trinity County, Texas",14689,7404,50.41%,49.60%,54.8,1518,10.33%,459,374,42,3837,703,1046,419,8864,1465,4296,1077,1088,29.25%,7.33%,7%,1314,12288,8.95%,91.05%,10533,1086,29,30,4,33,
0500000US48457,"Tyler County, Texas",21524,9818,45.61%,54.39%,45.1,1226,5.70%,959,395,68,6371,611,1606,571,12429,2177,7330,1006,1674,34.06%,4.67%,8%,1520,18278,7.06%,92.94%,15302,2040,111,97,3,47,
0500000US48459,"Upshur County, Texas",41386,21023,50.80%,49.20%,52.6,2556,6.18%,1340,1345,258,9828,2560,3552,1579,24408,5131,11168,3905,3810,26.98%,9.44%,9%,3986,36906,9.63%,90.37%,31287,2908,261,177,9,150,
0500000US48461,"Upton County, Texas",3651,1849,50.64%,49.36%,51.1,191,5.23%,141,48,29,891,82,229,100,1833,329,1032,130,258,28.27%,3.56%,7%,1797,1511,49.22%,50.78%,1318,59,11,4,0,3,
0500000US48463,"Uvalde County, Texas",26899,13814,51.36%,48.65%,45,2411,8.96%,949,1096,291,4960,1507,2432,829,12728,3261,5909,2603,2723,21.97%,9.68%,10%,17317,7247,64.38%,35.62%,6613,107,25,158,6,66,
0500000US48465,"Val Verde County, Texas",49018,24063,49.09%,50.91%,53.5,3786,7.72%,1794,1856,656,7287,1855,3694,1988,20807,5682,9081,3711,4350,18.53%,7.57%,9%,38207,9379,77.94%,22.06%,7836,538,57,351,35,85,
0500000US48467,"Van Zandt County, Texas",55970,28733,51.34%,48.66%,58.5,2972,5.31%,2243,1091,259,12815,3423,4562,1564,33124,6126,15058,4514,4821,26.90%,8.07%,9%,7071,52470,12.63%,87.37%,47986,1517,328,272,30,133,
0500000US48469,"Victoria County, Texas",92044,46900,50.95%,49.05%,49.3,5551,6.03%,2964,3474,457,18419,5860,7865,3554,50349,11419,21383,9334,8322,23.23%,10.14%,9%,42931,48388,46.64%,53.36%,39330,5230,214,1391,35,232,
0500000US48471,"Walker County, Texas",72295,30026,41.53%,58.47%,37.4,7931,10.97%,3287,10075,930,18642,2810,6135,2747,40153,8882,21929,12885,7065,30.33%,17.82%,10%,16578,59822,22.93%,77.07%,39823,16382,251,1126,39,318,
0500000US48473,"Waller County, Texas",53626,26968,50.29%,49.71%,45.1,3479,6.49%,3027,6372,569,9383,1500,4560,2287,25398,6847,12410,7872,5129,23.14%,14.68%,10%,18486,38308,34.47%,65.53%,23494,12104,210,785,10,314,
0500000US48475,"Ward County, Texas",11745,5840,49.72%,50.28%,54.5,790,6.73%,531,179,55,2690,463,671,179,5862,850,3221,642,726,27.42%,5.47%,6%,6325,5319,53.85%,46.15%,4506,415,41,69,2,22,
0500000US48477,"Washington County, Texas",35275,18145,51.44%,48.56%,50.2,1431,4.06%,1331,2086,255,7314,1817,4302,2324,20646,6626,8645,3903,4557,24.51%,11.06%,13%,6425,29380,18.21%,81.79%,22023,5555,75,547,14,140,
0500000US48479,"Webb County, Texas",274847,140040,50.95%,49.05%,46.2,29558,10.75%,11388,13542,1504,37611,11307,20488,8234,104327,28722,48999,24849,21992,17.83%,9.04%,8%,254354,12760,92.54%,7.46%,9495,788,135,1300,25,458,
0500000US48481,"Wharton County, Texas",41672,21092,50.61%,49.39%,50.7,2395,5.75%,1081,1627,111,7814,2514,3427,1618,21513,5045,8895,4141,3538,21.35%,9.94%,8%,16967,24603,40.72%,59.28%,18130,5469,69,164,0,104,
0500000US48483,"Wheeler County, Texas",5187,2479,47.79%,52.21%,51.8,343,6.61%,142,104,17,1075,319,416,119,2802,535,1217,423,433,23.46%,8.16%,8%,1227,3763,23.66%,76.34%,3469,81,33,24,2,12,
0500000US48485,"Wichita County, Texas",132154,63621,48.14%,51.86%,45.2,9852,7.45%,7583,7585,777,27618,7070,13050,6545,74773,19595,35201,14655,13827,26.64%,11.09%,10%,25803,103547,19.52%,80.48%,79694,13379,992,2647,140,476,
0500000US48487,"Wilbarger County, Texas",12717,6532,51.36%,48.64%,44.8,1023,8.04%,452,393,62,2939,597,1044,266,6925,1310,3391,990,1106,26.67%,7.78%,9%,3734,9153,29.36%,70.64%,7012,1013,96,566,0,32,
0500000US48489,"Willacy County, Texas",21419,9617,44.90%,55.10%,38.9,2154,10.06%,1063,834,17,5030,787,868,378,9482,1246,6093,1621,885,28.45%,7.57%,4%,17611,2553,82.22%,17.78%,1805,445,47,160,2,34,
0500000US48491,"Williamson County, Texas",570437,289410,50.74%,49.27%,53.4,14154,2.48%,16123,17739,5546,76864,32838,104976,54003,354174,158979,92987,50577,110522,16.30%,8.87%,19%,147088,461929,25.79%,74.21%,336410,38557,1659,53982,592,3124,
0500000US48493,"Wilson County, Texas",50110,25055,50.00%,50.00%,59.1,2480,4.95%,1432,1653,338,11661,2472,5430,2352,30081,7782,13093,4125,5768,26.13%,8.23%,12%,19232,30521,38.38%,61.62%,27877,693,148,229,24,187,
0500000US48495,"Winkler County, Texas",7822,3779,48.31%,51.69%,54.8,244,3.12%,605,178,25,1382,191,330,103,3130,433,1987,369,355,25.40%,4.72%,5%,4732,3059,60.50%,39.50%,2702,139,38,77,0,9,
0500000US48497,"Wise County, Texas",67884,33761,49.73%,50.27%,55.6,2629,3.87%,2874,1422,378,15630,4093,6412,2178,39333,8590,18504,5515,6790,27.26%,8.12%,10%,13694,54938,20.17%,79.83%,50495,657,474,372,12,172,
0500000US48499,"Wood County, Texas",45054,22728,50.45%,49.55%,53,2025,4.49%,1098,1638,94,10831,2367,3992,2291,28065,6283,11929,4005,4086,26.48%,8.89%,9%,4894,39949,10.86%,89.14%,35906,1658,227,230,1,138,
0500000US48501,"Yoakum County, Texas",8612,4155,48.25%,51.75%,56.9,353,4.10%,164,425,0,1528,211,504,93,3511,597,1692,636,504,19.65%,7.39%,6%,4968,2726,57.69%,42.31%,2488,55,22,46,0,15,
0500000US48503,"Young County, Texas",17961,9251,51.51%,48.49%,58,1001,5.57%,769,261,41,3784,598,2050,884,10558,2934,4553,859,2091,25.35%,4.78%,12%,3508,14359,19.53%,80.47%,13409,174,79,86,0,38,
0500000US48505,"Zapata County, Texas",14243,7248,50.89%,49.11%,41,2278,15.99%,623,414,164,2458,413,894,82,5196,976,3081,827,1058,21.63%,5.81%,7%,12999,890,91.27%,8.73%,796,9,7,16,0,16,
0500000US48507,"Zavala County, Texas",11930,5630,47.19%,52.81%,41.1,1928,16.16%,398,354,195,2486,461,495,383,5377,878,2884,815,690,24.17%,6.83%,6%,8944,726,74.97%,25.03%,572,67,21,19,1,3,
0500000US49001,"Beaver County, Utah",6594,3078,46.68%,53.32%,68.8,123,1.87%,135,361,0,1046,586,862,137,3537,999,1181,947,862,17.91%,14.36%,13%,1066,6006,16.17%,83.83%,5717,23,70,32,21,8,
0500000US49003,"Box Elder County, Utah",54953,26928,49.00%,51.00%,61.8,1559,2.84%,2253,1804,107,9937,3340,5656,2098,30392,7754,12190,5144,5763,22.18%,9.36%,10%,5537,52129,10.08%,89.92%,49361,161,383,438,98,102,
0500000US49005,"Cache County, Utah",126336,62994,49.86%,50.14%,57.3,7516,5.95%,5382,14667,2253,12940,4831,16272,8418,60016,24690,18322,19498,18525,14.50%,15.43%,15%,15076,118078,11.93%,88.07%,109376,1045,620,2303,660,422,
0500000US49007,"Carbon County, Utah",20401,10168,49.84%,50.16%,54.6,1313,6.44%,747,897,56,3897,2162,1471,752,12222,2223,4644,3059,1527,22.76%,14.99%,7%,2677,17735,13.12%,86.88%,16645,50,199,63,29,58,
0500000US49009,"Daggett County, Utah",590,265,44.92%,55.09%,61.3,17,2.88%,20,14,0,162,21,39,17,366,56,182,35,39,30.85%,5.93%,7%,29,906,4.92%,95.08%,881,1,0,1,2,2,
0500000US49011,"Davis County, Utah",350761,173597,49.49%,50.51%,60.2,7815,2.23%,11455,14529,2318,43575,22116,53067,25516,197441,78583,55030,36645,55385,15.69%,10.45%,16%,39295,323384,11.20%,88.80%,292458,4008,1464,6907,3204,1244,
0500000US49013,"Duchesne County, Utah",19950,9870,49.47%,50.53%,63.3,1323,6.63%,667,424,21,4510,988,1159,454,10485,1613,5177,1412,1180,25.95%,7.08%,6%,1285,18311,6.44%,93.56%,16736,21,875,60,39,47,
0500000US49015,"Emery County, Utah",10099,4940,48.92%,51.08%,65.1,397,3.93%,320,345,11,1909,1097,687,315,5992,1002,2229,1442,698,22.07%,14.28%,7%,705,9120,6.98%,93.02%,8811,2,55,36,7,16,
0500000US49017,"Garfield County, Utah",5000,2429,48.58%,51.42%,58.3,366,7.32%,192,65,18,1067,470,648,236,3263,884,1259,535,666,25.18%,10.70%,13%,384,4699,7.68%,92.32%,4446,5,90,30,7,3,
0500000US49019,"Grand County, Utah",9698,4797,49.46%,50.54%,60.8,866,8.93%,230,51,67,1931,787,1233,955,6695,2188,2161,838,1300,22.28%,8.64%,13%,1226,8443,12.64%,87.36%,7481,65,330,80,11,62,
0500000US49021,"Iron County, Utah",53148,26738,50.31%,49.69%,55.8,4157,7.82%,1785,5006,575,6903,3206,6205,2422,27904,8627,8688,8212,6780,16.35%,15.45%,13%,5482,51807,10.31%,89.69%,47620,375,948,621,237,154,
0500000US49023,"Juab County, Utah",11623,5687,48.93%,51.07%,59,582,5.01%,595,283,20,2475,658,762,462,6046,1224,3070,941,782,26.41%,8.10%,7%,574,11212,4.94%,95.06%,10781,11,89,32,41,10,
0500000US49025,"Kane County, Utah",7658,3763,49.14%,50.86%,47.8,444,5.80%,153,120,26,1391,541,1114,549,5120,1663,1544,661,1140,20.16%,8.63%,15%,322,7345,4.20%,95.80%,6924,27,119,59,1,18,
0500000US49027,"Millard County, Utah",12963,6335,48.87%,51.13%,66.8,371,2.86%,397,369,19,2565,909,1374,398,7100,1772,2962,1278,1393,22.85%,9.86%,11%,1774,11201,13.69%,86.31%,10636,15,100,141,13,27,
0500000US49029,"Morgan County, Utah",11950,5804,48.57%,51.43%,69.9,162,1.36%,224,666,8,1350,819,1548,1022,6550,2570,1574,1485,1556,13.17%,12.43%,13%,338,11957,2.83%,97.17%,11562,12,31,57,0,9,
0500000US49031,"Piute County, Utah",1870,914,48.88%,51.12%,55.1,140,7.49%,33,52,0,405,189,218,69,1231,287,438,241,218,23.42%,12.89%,12%,124,1314,6.63%,93.37%,1276,0,4,0,0,1,
0500000US49033,"Rich County, Utah",2415,1191,49.32%,50.68%,57.5,51,2.11%,130,62,0,397,142,208,102,1345,310,527,204,208,21.82%,8.45%,9%,97,2413,4.02%,95.98%,2329,11,1,2,4,1,
0500000US49035,"Salt Lake County, Utah",1146215,570761,49.80%,50.21%,51.8,44258,3.86%,37742,47154,10047,162491,67031,170110,95419,665272,265529,200233,114185,180157,17.47%,9.96%,16%,232088,953150,20.25%,79.75%,800914,21976,7205,50241,21194,5537,
0500000US49037,"San Juan County, Utah",15295,7705,50.38%,49.62%,46.1,1653,10.81%,652,497,68,2801,1111,1156,606,7879,1762,3453,1608,1224,22.58%,10.51%,8%,747,13771,4.88%,95.12%,6038,32,7186,34,51,26,
0500000US49039,"Sanpete County, Utah",30421,14344,47.15%,52.85%,55.5,1786,5.87%,1252,2636,32,5758,2074,2541,1236,16740,3777,7010,4710,2573,23.04%,15.48%,8%,3043,25394,10.00%,90.00%,23688,224,240,171,247,81,
0500000US49041,"Sevier County, Utah",21475,10345,48.17%,51.83%,61.4,1234,5.75%,480,697,85,4206,1422,1931,884,12263,2815,4686,2119,2016,21.82%,9.87%,9%,1053,20469,4.90%,95.10%,19396,65,313,40,49,49,
0500000US49043,"Summit County, Utah",41680,20330,48.78%,51.22%,59.3,1244,2.98%,1226,1585,395,4476,1275,9841,5829,26592,15670,5702,2860,10236,13.68%,6.86%,25%,4737,37620,11.37%,88.63%,35108,163,67,723,42,155,
0500000US49045,"Tooele County, Utah",69740,34638,49.67%,50.33%,57.2,1907,2.73%,3636,1692,204,12971,4381,6091,3282,37399,9373,16607,6073,6295,23.81%,8.71%,9%,9522,63176,13.65%,86.35%,58199,436,445,511,637,282,
0500000US49047,"Uintah County, Utah",35736,17746,49.66%,50.34%,52.4,2317,6.48%,1322,947,42,7958,1485,2505,899,18481,3404,9280,2432,2547,25.97%,6.81%,7%,2834,32786,7.93%,92.07%,28726,90,2277,157,97,116,
0500000US49049,"Utah County, Utah",621506,307322,49.45%,50.55%,58.4,28726,4.62%,28187,61556,7047,51916,32697,88312,39245,295162,127557,80103,94253,95359,12.89%,15.17%,15%,88531,570868,14.24%,85.76%,518460,4110,2533,10111,6541,2421,
0500000US49051,"Wasatch County, Utah",33053,16212,49.05%,50.95%,64.8,602,1.82%,1016,1166,226,4099,1667,5742,2958,19006,8700,5115,2833,5968,15.48%,8.57%,18%,5046,29742,15.27%,84.73%,28168,141,67,347,41,65,
0500000US49053,"Washington County, Utah",172127,87163,50.64%,49.36%,60,6295,3.66%,5142,7790,370,25232,15324,20939,11788,105213,32727,30374,23114,21309,17.65%,13.43%,12%,20482,159797,11.90%,88.10%,147462,913,1566,1802,1607,631,
0500000US49055,"Wayne County, Utah",2698,1307,48.44%,51.56%,65.5,153,5.67%,98,54,0,346,306,374,64,1632,438,444,360,374,16.46%,13.34%,14%,96,2390,3.56%,96.44%,2267,1,19,16,3,5,
0500000US49057,"Weber County, Utah",255284,126918,49.72%,50.28%,53,9434,3.70%,9490,10863,966,46466,14910,27871,12002,145418,39873,55956,25773,28837,21.92%,10.10%,11%,48742,213481,19.09%,80.91%,193889,3209,1394,3603,948,1014,
0500000US50001,"Addison County, Vermont",36947,18596,50.33%,49.67%,48.7,1115,3.02%,1639,2850,473,7698,2106,6421,4096,24194,10517,9337,4956,6894,25.27%,13.41%,19%,1153,36210,3.12%,96.88%,33440,342,80,594,10,110,
0500000US50003,"Bennington County, Vermont",35649,18331,51.42%,48.58%,48,1907,5.35%,1373,1432,244,7146,1940,5594,3942,23565,9536,8519,3372,5838,23.90%,9.46%,16%,939,36408,2.63%,97.37%,33897,405,63,397,5,119,
0500000US50005,"Caledonia County, Vermont",30027,14897,49.61%,50.39%,50.5,1636,5.45%,1072,1119,153,7508,1760,4194,2418,20012,6612,8580,2879,4347,28.57%,9.59%,14%,605,29628,2.01%,97.99%,27465,214,94,363,17,119,
0500000US50007,"Chittenden County, Vermont",163414,83009,50.80%,49.20%,44.3,8010,4.90%,6113,14359,4416,20038,9768,33637,23330,102651,56967,26151,24127,38053,16.00%,14.76%,23%,4751,163572,2.91%,97.09%,142880,4757,291,7203,49,762,
0500000US50009,"Essex County, Vermont",6179,3086,49.94%,50.06%,55.4,357,5.78%,162,131,11,2079,446,467,409,4198,876,2241,577,478,36.27%,9.34%,8%,67,5853,1.08%,98.92%,5544,15,14,16,5,5,
0500000US50011,"Franklin County, Vermont",49275,24773,50.28%,49.73%,53.5,2219,4.50%,1937,983,407,12954,3254,5899,3249,31427,9148,14891,4237,6306,30.22%,8.60%,13%,915,49031,1.86%,98.14%,45239,321,483,312,16,120,
0500000US50013,"Grand Isle County, Vermont",7075,3507,49.57%,50.43%,58.8,253,3.58%,176,167,81,1494,477,1310,951,5028,2261,1670,644,1391,23.60%,9.10%,20%,127,7166,1.80%,98.20%,6697,49,39,30,0,16,
0500000US50015,"Lamoille County, Vermont",25376,12681,49.97%,50.03%,51.1,1465,5.77%,919,1082,110,4367,1708,4606,2703,16474,7309,5286,2790,4716,20.83%,10.99%,19%,651,25294,2.57%,97.43%,23585,217,88,141,1,121,
0500000US50017,"Orange County, Vermont",28873,14464,50.10%,49.91%,53.1,1211,4.19%,900,793,197,7355,2245,3464,3340,19739,6804,8255,3038,3661,28.59%,10.52%,13%,477,28800,1.65%,98.35%,26852,151,113,160,5,119,
0500000US50019,"Orleans County, Vermont",26843,13388,49.88%,50.13%,54.3,1336,4.98%,912,725,77,7498,1866,2923,1835,17589,4758,8410,2591,3000,31.33%,9.65%,11%,462,26931,1.72%,98.28%,25259,127,197,119,1,59,
0500000US50021,"Rutland County, Vermont",58527,29597,50.57%,49.43%,50.3,2259,3.86%,2031,2351,520,14352,4190,8576,5171,40028,13747,16383,6541,9096,27.99%,11.18%,16%,1225,59347,2.09%,97.91%,55092,493,146,458,14,171,
0500000US50023,"Washington County, Vermont",58336,29527,50.62%,49.39%,47.2,3021,5.18%,2283,2345,494,10669,3286,10560,7668,39300,18228,12952,5631,11054,22.20%,9.65%,19%,1569,58238,2.69%,97.31%,53704,612,135,632,23,319,
0500000US50025,"Windham County, Vermont",42628,21897,51.37%,48.63%,44.3,2136,5.01%,1313,1268,261,9526,2376,7166,5450,29763,12616,10839,3644,7427,25.43%,8.55%,17%,1333,44572,3.13%,96.87%,41010,495,99,493,8,243,
0500000US50027,"Windsor County, Vermont",55191,28146,51.00%,49.00%,53.4,2189,3.97%,1325,899,705,12208,3671,9123,6826,39364,15949,13533,4570,9828,24.52%,8.28%,18%,1230,56523,2.23%,97.77%,52537,451,144,539,16,278,
0500000US51001,"Accomack County, Virginia",32560,16620,51.04%,48.96%,52.1,2450,7.52%,1138,430,160,8771,2044,2697,1996,19636,4693,9909,2474,2857,30.43%,7.60%,9%,3430,29983,10.53%,89.47%,19825,8639,65,249,1,99,
0500000US51003,"Albemarle County, Virginia",108819,56941,52.33%,47.67%,51.2,3988,3.66%,4370,5908,2132,10736,3618,22495,20865,68406,43360,15106,9526,24627,13.88%,8.75%,23%,8453,103942,7.77%,92.23%,80335,9793,96,8186,44,604,
0500000US51005,"Alleghany County, Virginia",15030,7655,50.93%,49.07%,50,1378,9.17%,410,443,78,4761,1087,943,683,9967,1626,5171,1530,1021,34.40%,10.18%,7%,178,15045,1.18%,98.82%,13754,676,22,59,7,24,
0500000US51007,"Amelia County, Virginia",12970,6428,49.56%,50.44%,56.3,517,3.99%,361,410,7,3967,579,1046,639,7937,1685,4328,989,1053,33.37%,7.63%,8%,425,12840,3.28%,96.72%,9687,2546,18,63,0,50,
0500000US51009,"Amherst County, Virginia",31782,16495,51.90%,48.10%,49.6,1496,4.71%,958,1215,276,8689,2274,3129,1753,19831,4882,9647,3489,3405,30.35%,10.98%,11%,838,30469,2.64%,97.36%,22967,5346,243,182,25,145,
0500000US51011,"Appomattox County, Virginia",15814,8182,51.74%,48.26%,58,1010,6.39%,316,597,86,4155,977,1797,623,9894,2420,4471,1574,1883,28.27%,9.95%,12%,344,15775,2.18%,97.82%,12155,2877,50,42,3,84,
0500000US51013,"Arlington County, Virginia",236434,118040,49.93%,50.08%,44,7996,3.38%,2878,4416,10613,13788,5589,61669,70725,165755,132394,16666,10005,72282,7.05%,4.23%,31%,37362,201281,15.80%,84.20%,139653,20330,258,27235,118,1491,
0500000US51015,"Augusta County, Virginia",75754,37231,49.15%,50.85%,54.9,2647,3.49%,2727,1272,792,22390,4157,8226,4194,49416,12420,25117,5429,9018,33.16%,7.17%,12%,2728,74759,3.60%,96.40%,68375,3072,130,461,27,198,
0500000US51017,"Bath County, Virginia",4248,2014,47.41%,52.59%,55.4,270,6.36%,159,82,9,1304,230,441,145,2947,586,1463,312,450,34.44%,7.34%,11%,73,4136,1.72%,98.28%,3841,114,3,17,1,4,
0500000US51019,"Bedford County, Virginia",78965,40170,50.87%,49.13%,61.2,2842,3.60%,2203,2232,822,17269,5194,10611,7088,52688,17699,19472,7426,11433,24.66%,9.40%,14%,2055,77407,2.60%,97.40%,68128,4864,167,967,33,329,
0500000US51021,"Bland County, Virginia",6334,2764,43.64%,56.36%,46.5,197,3.11%,132,111,0,2126,504,461,203,4391,664,2258,615,461,35.65%,9.71%,7%,60,6210,0.95%,99.05%,5857,167,0,4,0,5,
0500000US51023,"Botetourt County, Virginia",33440,16964,50.73%,49.27%,60.4,878,2.63%,967,853,177,8491,3112,4104,2539,23122,6643,9458,3965,4281,28.28%,11.86%,13%,776,32820,2.32%,97.68%,30506,905,43,234,3,102,
0500000US51025,"Brunswick County, Virginia",16336,7508,45.96%,54.04%,33.6,831,5.09%,680,596,54,4489,702,1016,814,9500,1830,5169,1298,1070,31.64%,7.95%,7%,387,15462,2.37%,97.63%,6457,8573,23,42,5,29,
0500000US51027,"Buchanan County, Virginia",21374,10744,50.27%,49.73%,48,1905,8.91%,522,716,95,5978,1030,903,1005,11741,1908,6500,1746,998,30.41%,8.17%,5%,177,20178,0.83%,99.17%,19210,613,15,49,1,10,
0500000US51029,"Buckingham County, Virginia",17087,7806,45.68%,54.32%,43.8,910,5.33%,437,360,92,5688,743,906,730,10677,1636,6125,1103,998,35.85%,6.46%,6%,413,16411,2.42%,97.58%,10314,5390,44,59,0,52,
0500000US51031,"Campbell County, Virginia",55406,28559,51.55%,48.46%,52.4,2540,4.58%,1578,1608,737,13383,3105,6167,3217,35469,9384,14961,4713,6904,27.00%,8.51%,12%,1815,53881,3.28%,96.72%,42884,7761,169,601,8,241,
0500000US51033,"Caroline County, Virginia",30581,15480,50.62%,49.38%,50.1,1294,4.23%,1281,1159,160,8022,1558,2982,1528,18161,4510,9303,2717,3142,30.42%,8.88%,10%,1968,28919,6.44%,93.56%,18841,7627,160,296,15,163,
0500000US51035,"Carroll County, Virginia",29911,14829,49.58%,50.42%,53.6,1620,5.42%,794,883,23,8565,2418,2406,929,18275,3335,9359,3301,2429,31.29%,11.04%,8%,1042,28113,3.48%,96.52%,27040,163,35,80,3,42,
0500000US51036,"Charles City County, Virginia",6965,3541,50.84%,49.16%,48.2,429,6.16%,189,156,26,2175,370,624,262,4454,886,2364,526,650,33.94%,7.55%,9%,101,6672,1.45%,98.55%,2997,2836,441,34,6,50,
0500000US51037,"Charlotte County, Virginia",11953,5945,49.74%,50.26%,43.3,1216,10.17%,336,362,11,3198,934,736,429,7032,1165,3534,1296,747,29.57%,10.84%,6%,253,11276,2.12%,97.88%,7677,3140,18,23,6,35,
0500000US51041,"Chesterfield County, Virginia",348500,180712,51.85%,48.15%,53,10602,3.04%,10600,12205,3098,54338,20642,58481,35658,217618,94139,64938,32847,61579,18.63%,9.43%,18%,40236,324312,11.55%,88.45%,210881,81492,848,13096,177,2098,
0500000US51043,"Clarke County, Virginia",14498,7242,49.95%,50.05%,58.4,418,2.88%,392,482,136,3069,999,2106,1564,9707,3670,3461,1481,2242,23.87%,10.22%,15%,887,13896,6.12%,93.88%,12309,564,33,210,15,89,
0500000US51045,"Craig County, Virginia",5103,2658,52.09%,47.91%,64.4,164,3.21%,295,19,38,1432,428,625,209,3521,834,1727,447,663,33.84%,8.76%,13%,53,4839,1.04%,98.96%,4631,11,5,11,3,12,
0500000US51047,"Culpeper County, Virginia",51935,26221,50.49%,49.51%,50.9,1402,2.70%,1817,1481,328,10921,3058,5587,3259,30619,8846,12738,4539,5915,24.53%,8.74%,11%,7509,45043,14.46%,85.54%,34840,6453,110,767,20,233,
0500000US51049,"Cumberland County, Virginia",9869,5131,51.99%,48.01%,48.8,411,4.16%,404,197,28,2566,665,532,670,6231,1202,2970,862,560,30.09%,8.73%,6%,241,9434,2.44%,97.56%,6104,2817,39,36,8,40,
0500000US51051,"Dickenson County, Virginia",14524,7148,49.22%,50.79%,46.9,1394,9.60%,428,418,55,3919,1030,913,308,8406,1221,4347,1448,968,29.93%,9.97%,7%,83,14041,0.57%,99.43%,13691,48,22,12,2,12,
0500000US51053,"Dinwiddie County, Virginia",28686,14625,50.98%,49.02%,48,1293,4.51%,816,1185,21,7587,1903,2322,1317,17262,3639,8403,3088,2343,29.29%,10.76%,8%,1128,26819,3.93%,96.07%,17346,8115,91,119,3,102,
0500000US51057,"Essex County, Virginia",10960,5946,54.25%,45.75%,48.5,709,6.47%,415,526,88,2812,307,953,320,6499,1273,3227,833,1041,29.44%,7.60%,9%,369,10230,3.37%,96.63%,5871,3743,61,62,3,40,
0500000US51059,"Fairfax County, Virginia",1149439,579167,50.39%,49.61%,55.3,32610,2.84%,23670,37734,22892,98997,43486,242936,243879,726047,486815,122667,81220,265828,10.67%,7.07%,23%,199234,951075,17.33%,82.67%,542001,108339,1437,233858,772,7046,
0500000US51061,"Fauquier County, Virginia",70353,35587,50.58%,49.42%,54.3,1509,2.14%,1913,2092,840,11795,3974,11087,6751,44678,17838,13708,6066,11927,19.48%,8.62%,17%,7793,65179,11.08%,88.92%,54969,4999,128,1204,49,339,
0500000US51063,"Floyd County, Virginia",15766,7963,50.51%,49.49%,56.9,840,5.33%,477,471,3,4259,1381,1612,927,10422,2539,4736,1852,1615,30.04%,11.75%,10%,487,14989,3.09%,96.91%,14114,234,18,46,0,72,
0500000US51065,"Fluvanna County, Virginia",26873,14402,53.59%,46.41%,53.2,681,2.53%,591,716,132,4713,1540,4430,2609,18283,7039,5304,2256,4562,19.74%,8.40%,17%,1107,26142,4.12%,95.88%,20760,3669,68,212,7,155,
0500000US51067,"Franklin County, Virginia",56231,28555,50.78%,49.22%,52.3,3379,6.01%,1790,1749,683,14041,3852,5698,3604,36168,9302,15831,5601,6381,28.15%,9.96%,11%,1955,52522,3.48%,96.52%,46218,3848,75,303,20,153,
0500000US51069,"Frederick County, Virginia",88054,44007,49.98%,50.02%,54.5,2553,2.90%,2675,2177,833,19466,5125,9403,6974,53946,16377,22141,7302,10236,25.14%,8.29%,12%,9990,81429,11.35%,88.65%,71739,3605,120,1661,39,402,
0500000US51071,"Giles County, Virginia",16760,8591,51.26%,48.74%,51.6,884,5.27%,456,367,69,4582,1105,1406,967,10930,2373,5038,1472,1475,30.06%,8.78%,9%,244,16543,1.46%,98.54%,15673,238,28,69,0,19,
0500000US51073,"Gloucester County, Virginia",37362,18970,50.77%,49.23%,55.7,1517,4.06%,1048,1280,105,8455,2422,4295,2267,24348,6562,9503,3702,4400,25.43%,9.91%,12%,1410,37301,3.77%,96.23%,31974,2706,129,305,21,143,
0500000US51075,"Goochland County, Virginia",23472,11774,50.16%,49.84%,60.3,559,2.38%,445,608,239,4080,1167,4174,3531,16371,7705,4525,1775,4413,19.28%,7.56%,19%,862,23865,3.67%,96.33%,19081,3252,58,493,3,146,
0500000US51077,"Grayson County, Virginia",15651,7579,48.43%,51.58%,54.5,642,4.10%,434,457,58,4398,1501,1397,524,9949,1921,4832,1958,1455,30.87%,12.51%,9%,596,14737,3.81%,96.19%,13396,887,26,24,2,30,
0500000US51079,"Greene County, Virginia",19734,10288,52.13%,47.87%,57.8,653,3.31%,824,222,174,4085,1046,2145,1961,12047,4106,4909,1268,2319,24.88%,6.43%,12%,1330,19222,6.74%,93.26%,16214,1442,26,456,4,92,
0500000US51081,"Greensville County, Virginia",11403,4309,37.79%,62.21%,36.2,669,5.87%,289,328,21,3557,531,641,352,6880,993,3846,859,662,33.73%,7.53%,6%,276,11115,2.42%,97.58%,4217,6616,19,32,0,13,
0500000US51083,"Halifax County, Virginia",34295,17936,52.30%,47.70%,45.9,2050,5.98%,1142,883,176,9042,2365,2536,1441,20389,3977,10184,3248,2712,29.70%,9.47%,8%,760,33262,2.22%,97.78%,20250,11738,77,218,3,112,
0500000US51085,"Hanover County, Virginia",106538,54069,50.75%,49.25%,56.7,2272,2.13%,3221,4297,857,18938,6171,19046,10728,69335,29774,22159,10468,19903,20.80%,9.83%,19%,3938,106041,3.70%,96.30%,88869,9678,311,2021,32,510,
0500000US51087,"Henrico County, Virginia",330076,173593,52.59%,47.41%,47.2,12615,3.82%,8024,9878,3990,49847,16827,61652,39980,212308,101632,57871,26705,65642,17.53%,8.09%,20%,22085,312304,6.69%,93.31%,167030,96332,888,32175,127,1955,
0500000US51089,"Henry County, Virginia",51032,26492,51.91%,48.09%,45.7,3065,6.01%,1256,1488,173,13003,4193,3583,2103,30152,5686,14259,5681,3756,27.94%,11.13%,7%,3301,47647,6.47%,93.53%,34307,11062,68,284,6,153,
0500000US51091,"Highland County, Virginia",2202,1252,56.86%,43.14%,59.7,78,3.54%,176,18,0,601,54,332,188,1523,520,777,72,332,35.29%,3.27%,15%,35,2197,1.59%,98.41%,2132,2,1,6,1,8,
0500000US51093,"Isle of Wight County, Virginia",37107,18881,50.88%,49.12%,54.8,1476,3.98%,1073,1007,284,7919,2710,4447,3023,23689,7470,8992,3717,4731,24.23%,10.02%,13%,1199,37407,3.23%,96.77%,26410,8579,139,391,31,202,
0500000US51095,"James City County, Virginia",76032,39543,52.01%,47.99%,58.2,1992,2.62%,1817,2498,592,9852,5192,14860,13431,52971,28291,11669,7690,15452,15.35%,10.11%,20%,5199,73055,6.84%,93.16%,56647,9832,165,2254,48,361,
0500000US51097,"King and Queen County, Virginia",7011,3430,48.92%,51.08%,54.6,751,10.71%,114,166,10,1944,415,1024,369,4888,1393,2058,581,1034,29.35%,8.29%,15%,182,6426,2.60%,97.40%,4460,1561,82,23,3,19,
0500000US51099,"King George County, Virginia",26679,13232,49.60%,50.40%,56.5,598,2.24%,1115,679,240,4781,1565,3877,2417,16424,6294,5896,2244,4117,22.10%,8.41%,15%,1582,25141,5.93%,94.07%,18709,3919,153,401,13,147,
0500000US51101,"King William County, Virginia",16985,8649,50.92%,49.08%,58.1,254,1.50%,375,525,100,3903,1093,1998,852,11141,2850,4278,1618,2098,25.19%,9.53%,12%,476,17334,2.80%,97.20%,13499,2585,277,129,9,76,
0500000US51103,"Lancaster County, Virginia",10686,5900,55.21%,44.79%,56.3,478,4.47%,84,165,79,2623,598,1489,1433,7765,2922,2707,763,1568,25.33%,7.14%,15%,125,10794,1.17%,98.83%,7441,2946,14,77,1,39,
0500000US51105,"Lee County, Virginia",23723,11301,47.64%,52.36%,44.3,2714,11.44%,747,559,67,6274,1157,1289,433,14154,1722,7021,1716,1356,29.60%,7.23%,6%,476,21697,2.01%,97.99%,20193,868,69,39,0,33,
0500000US51107,"Loudoun County, Virginia",405312,204035,50.34%,49.66%,61.3,7548,1.86%,7963,12291,6103,32316,15841,91815,69038,245175,160853,40279,28132,97918,9.94%,6.94%,24%,59744,361215,14.74%,85.26%,216865,29725,536,89372,227,2425,
0500000US51109,"Louisa County, Virginia",36654,18670,50.94%,49.06%,58.1,1192,3.25%,1196,874,246,8997,2052,4083,2616,23538,6699,10193,2926,4329,27.81%,7.98%,12%,1365,36231,3.72%,96.28%,28535,5365,93,251,18,155,
0500000US51111,"Lunenburg County, Virginia",12294,5984,48.67%,51.33%,49.8,583,4.74%,413,415,5,3567,748,802,314,7319,1116,3980,1163,807,32.37%,9.46%,7%,589,11347,4.79%,95.21%,7016,3773,32,25,5,31,
0500000US51113,"Madison County, Virginia",13208,6855,51.90%,48.10%,58.2,527,3.99%,435,153,124,3387,640,1502,866,8569,2368,3822,793,1626,28.94%,6.00%,12%,441,13396,3.34%,96.66%,11563,1056,14,86,1,53,
0500000US51115,"Mathews County, Virginia",8760,4389,50.10%,49.90%,51.5,486,5.55%,366,187,51,1900,633,1488,494,6265,1982,2266,820,1539,25.87%,9.36%,18%,197,8336,2.25%,97.75%,7250,658,7,49,15,25,
0500000US51117,"Mecklenburg County, Virginia",30726,15692,51.07%,48.93%,46.2,2475,8.06%,872,801,119,7336,2173,3384,1899,19390,5283,8208,2974,3503,26.71%,9.68%,11%,821,29498,2.67%,97.33%,17864,10364,73,205,0,110,
0500000US51119,"Middlesex County, Virginia",10642,5359,50.36%,49.64%,54.3,567,5.33%,187,346,25,2501,738,1454,767,7258,2221,2688,1084,1479,25.26%,10.19%,14%,259,10366,2.43%,97.57%,8339,1519,24,26,3,40,
0500000US51121,"Montgomery County, Virginia",98495,47625,48.35%,51.65%,38.5,16080,16.33%,4544,19221,2811,12979,3490,12100,13770,52715,25870,17523,22711,14911,17.79%,23.06%,15%,4651,95070,4.72%,95.28%,77918,4054,126,8310,45,307,
0500000US51125,"Nelson County, Virginia",14812,7382,49.84%,50.16%,57.1,745,5.03%,318,491,112,4018,583,1974,1457,9475,3431,4336,1074,2086,29.27%,7.25%,14%,663,14112,4.48%,95.52%,11879,1526,47,67,2,68,
0500000US51127,"New Kent County, Virginia",22310,10945,49.06%,50.94%,62,204,0.91%,496,352,276,5039,1317,3371,1905,15383,5276,5535,1669,3647,24.81%,7.48%,16%,731,22214,3.28%,96.72%,17818,2714,225,223,8,102,
0500000US51131,"Northampton County, Virginia",11826,6240,52.77%,47.24%,49.5,577,4.88%,283,329,58,2999,556,1342,949,7459,2291,3282,885,1400,27.75%,7.48%,12%,1068,11214,9.03%,90.97%,6932,3756,58,80,8,30,
0500000US51133,"Northumberland County, Virginia",12151,6250,51.44%,48.56%,58.6,857,7.05%,261,85,24,3040,884,1739,1439,8979,3178,3301,969,1763,27.17%,7.97%,15%,351,11488,2.89%,97.11%,8310,2673,14,67,0,59,
0500000US51135,"Nottoway County, Virginia",15338,7023,45.79%,54.21%,44.4,842,5.49%,579,493,92,4281,904,1123,597,9121,1720,4860,1397,1215,31.69%,9.11%,8%,773,14869,5.04%,94.96%,8452,5773,50,64,3,72,
0500000US51137,"Orange County, Virginia",36501,18551,50.82%,49.18%,54.8,2020,5.53%,1161,1122,306,9427,1548,4208,2463,23288,6671,10588,2670,4514,29.01%,7.31%,12%,2171,34083,5.95%,94.05%,27389,4304,92,311,18,156,
0500000US51139,"Page County, Virginia",23862,12103,50.72%,49.28%,52.1,1082,4.53%,788,713,73,8134,1012,1472,1028,14634,2500,8922,1725,1545,37.39%,7.23%,6%,497,23212,2.08%,97.92%,21870,436,49,115,8,40,
0500000US51141,"Patrick County, Virginia",17660,8875,50.26%,49.75%,58,1321,7.48%,312,580,72,4952,1516,1295,721,11136,2016,5264,2096,1367,29.81%,11.87%,8%,567,17041,3.21%,96.79%,15577,831,24,43,3,72,
0500000US51143,"Pittsylvania County, Virginia",60867,30972,50.89%,49.12%,54.7,2734,4.49%,1407,1833,409,16810,4285,4700,2162,37953,6862,18217,6118,5109,29.93%,10.05%,8%,1712,58789,2.81%,97.19%,44277,12354,93,289,17,128,
0500000US51145,"Powhatan County, Virginia",29253,14065,48.08%,51.92%,58.4,624,2.13%,826,766,163,6590,1797,4648,2032,19573,6680,7416,2563,4811,25.35%,8.76%,16%,792,29541,2.71%,97.29%,25497,2477,59,167,18,99,
0500000US51147,"Prince Edward County, Virginia",22892,11308,49.40%,50.60%,30.6,1683,7.35%,1790,3799,265,4528,512,1962,1396,11260,3358,6318,4311,2227,27.60%,18.83%,10%,1088,20761,4.75%,95.25%,10513,9194,33,196,0,61,
0500000US51149,"Prince George County, Virginia",38292,17751,46.36%,53.64%,48,1542,4.03%,1328,1371,110,8060,2751,4419,1788,23794,6207,9388,4122,4529,24.52%,10.76%,12%,4344,38666,11.34%,88.66%,22662,12694,221,822,141,191,
0500000US51153,"Prince William County, Virginia",466834,233528,50.02%,49.98%,54.1,12902,2.76%,13782,17397,4484,59534,23840,74526,50889,266812,125415,73316,41237,79010,15.70%,8.83%,17%,121524,360680,26.03%,73.97%,185048,94939,745,49836,507,3384,
0500000US51155,"Pulaski County, Virginia",34113,16999,49.83%,50.17%,51.9,1738,5.09%,1190,872,194,8637,3023,3201,1853,22824,5054,9827,3895,3395,28.81%,11.42%,10%,704,33096,2.06%,97.94%,29716,1633,49,177,3,100,
0500000US51157,"Rappahannock County, Virginia",7360,3728,50.65%,49.35%,55,271,3.68%,192,181,21,1411,423,1058,814,4989,1872,1603,604,1079,21.78%,8.21%,15%,289,7059,3.93%,96.07%,6444,198,17,63,0,30,
0500000US51159,"Richmond County, Virginia",8951,3913,43.72%,56.28%,49.9,885,9.89%,239,124,106,2462,661,794,456,5544,1250,2701,785,900,30.18%,8.77%,10%,597,8326,6.67%,93.33%,5564,2419,16,42,0,5,
0500000US51161,"Roanoke County, Virginia",94103,48582,51.63%,48.37%,52.5,2751,2.92%,2645,2422,1037,18531,7496,16113,8367,63478,24480,21176,9918,17150,22.50%,10.54%,18%,3507,93422,3.73%,96.27%,79928,5650,155,3425,24,435,
0500000US51163,"Rockbridge County, Virginia",22728,11409,50.20%,49.80%,54.7,1317,5.79%,514,801,122,5921,1084,2560,2137,15153,4697,6435,1885,2682,28.31%,8.29%,12%,513,22137,2.26%,97.74%,20357,565,85,181,6,82,
0500000US51165,"Rockingham County, Virginia",81138,41424,51.05%,48.95%,54.7,2768,3.41%,2814,2860,733,20040,3963,8970,6120,47627,15090,22854,6823,9703,28.17%,8.41%,12%,7093,76664,8.74%,91.26%,71367,1768,80,920,9,243,
0500000US51167,"Russell County, Virginia",26937,13680,50.79%,49.22%,50.3,1983,7.36%,848,689,169,7547,2038,1377,647,16061,2024,8395,2727,1546,31.17%,10.12%,6%,168,25613,0.62%,99.38%,24754,222,17,42,1,25,
0500000US51169,"Scott County, Virginia",21761,10750,49.40%,50.60%,50,1020,4.69%,646,508,130,5925,1757,1596,857,13410,2453,6571,2265,1726,30.20%,10.41%,8%,255,21321,1.17%,98.83%,20528,134,26,20,2,28,
0500000US51171,"Shenandoah County, Virginia",43441,22080,50.83%,49.17%,51.1,1779,4.10%,1428,1184,110,12779,2682,3970,2151,27434,6121,14207,3866,4080,32.70%,8.90%,9%,3726,40460,8.58%,91.42%,37304,1031,84,344,8,149,
0500000US51173,"Smyth County, Virginia",30539,15489,50.72%,49.28%,50.4,2375,7.78%,1023,762,106,8416,2339,2226,1111,18710,3337,9439,3101,2332,30.91%,10.15%,8%,558,29242,1.83%,98.17%,27762,408,36,104,1,49,
0500000US51175,"Southampton County, Virginia",17829,8504,47.70%,52.30%,47.1,499,2.80%,426,504,102,3999,1282,1746,810,11302,2556,4425,1786,1848,24.82%,10.02%,10%,332,17664,1.86%,98.14%,10959,5908,56,67,20,50,
0500000US51177,"Spotsylvania County, Virginia",134683,68492,50.85%,49.15%,54.1,3518,2.61%,4462,4014,1064,25546,7139,17962,10915,82229,28877,30008,11153,19026,22.28%,8.28%,14%,16654,123378,12.37%,87.63%,87278,22436,375,3933,122,845,
0500000US51179,"Stafford County, Virginia",150185,74325,49.49%,50.51%,55.2,2907,1.94%,5676,5971,1538,21530,7743,23767,16105,89718,39872,27206,13714,25305,18.11%,9.13%,17%,23646,133281,15.74%,84.26%,85587,29492,601,6137,241,1105,
0500000US51181,"Surry County, Virginia",6459,3356,51.96%,48.04%,49.7,144,2.23%,165,82,100,1678,313,721,284,4162,1005,1843,395,821,28.53%,6.12%,13%,149,6412,2.31%,97.69%,3459,2687,17,14,10,15,
0500000US51183,"Sussex County, Virginia",11202,4397,39.25%,60.75%,39.7,442,3.95%,498,511,36,3393,552,770,332,6689,1102,3891,1063,806,34.73%,9.49%,7%,306,10523,2.73%,97.27%,4381,5766,14,11,7,25,
0500000US51185,"Tazewell County, Virginia",41201,20758,50.38%,49.62%,50.7,2910,7.06%,1059,1272,275,11140,3294,2946,1621,25109,4567,12199,4566,3221,29.61%,11.08%,8%,507,39922,1.23%,98.77%,37336,961,56,213,15,89,
0500000US51187,"Warren County, Virginia",39888,20014,50.18%,49.83%,50.9,2552,6.40%,1577,1236,211,10056,2093,3807,1965,24406,5772,11633,3329,4018,29.16%,8.35%,10%,2413,38314,6.05%,93.95%,33831,1722,130,462,13,255,
0500000US51191,"Washington County, Virginia",54005,27374,50.69%,49.31%,52.9,2470,4.57%,1686,1768,388,13150,4211,6021,3678,34535,9699,14836,5979,6409,27.47%,11.07%,12%,891,53044,1.65%,98.35%,50338,651,91,334,0,134,
0500000US51193,"Westmoreland County, Virginia",17873,9059,50.69%,49.32%,44.9,1668,9.33%,597,289,199,4816,948,1321,1119,11171,2440,5413,1237,1520,30.29%,6.92%,9%,1049,17428,5.87%,94.13%,11758,4470,67,146,11,68,
0500000US51195,"Wise County, Virginia",38032,18197,47.85%,52.15%,49.1,3274,8.61%,1230,1689,150,8897,2761,2295,1755,21150,4050,10127,4450,2445,26.63%,11.70%,6%,452,35678,1.19%,98.81%,32586,1771,48,150,11,86,
0500000US51197,"Wythe County, Virginia",28725,14691,51.14%,48.86%,56.8,1294,4.50%,651,795,237,8220,2457,2373,1642,18460,4015,8871,3252,2610,30.88%,11.32%,9%,355,27935,1.24%,98.76%,26082,699,54,118,2,66,
0500000US51199,"York County, Virginia",68389,34862,50.98%,49.02%,61.5,1636,2.39%,1858,2626,961,8062,4694,12367,10532,44047,22899,9920,7320,13328,14.51%,10.70%,19%,5136,64909,7.51%,92.49%,46932,8633,168,4251,127,416,
0500000US51510,"Alexandria city, Virginia",158309,82057,51.83%,48.17%,43.7,6611,4.18%,2465,3130,2616,12364,6434,37466,40573,111579,78039,14829,9564,40082,9.37%,6.04%,25%,29372,130095,18.55%,81.45%,78519,31314,217,11205,77,1026,
0500000US51520,"Bristol city, Virginia",17059,8945,52.44%,47.56%,45,1583,9.28%,681,417,51,3813,946,1270,1386,10505,2656,4494,1363,1321,26.34%,7.99%,8%,455,16764,2.67%,97.33%,14652,1008,55,159,4,36,
0500000US51530,"Buena Vista city, Virginia",6477,3578,55.24%,44.76%,46.6,213,3.29%,244,803,45,1356,185,407,360,3204,767,1600,988,452,24.70%,15.25%,7%,229,6412,3.54%,96.46%,5660,289,39,24,24,18,
0500000US51540,"Charlottesville city, Virginia",47217,24571,52.04%,47.96%,33.9,7127,15.09%,1706,5823,1823,5033,1478,8230,8685,27592,16915,6739,7301,10053,14.27%,15.46%,21%,3207,43346,6.79%,93.21%,29609,7030,66,4064,18,218,
0500000US51550,"Chesapeake city, Virginia",242647,124043,51.12%,48.88%,53.8,8448,3.48%,7225,8591,2301,38715,16717,35525,20953,152194,56478,45940,25308,37826,18.93%,10.43%,16%,17824,231598,7.35%,92.65%,135679,70885,731,8868,312,1223,
0500000US51570,"Colonial Heights city, Virginia",17283,9321,53.93%,46.07%,45.8,801,4.63%,621,420,65,3765,1263,1910,1322,11153,3232,4386,1683,1975,25.38%,9.74%,11%,1276,16894,7.38%,92.62%,12409,2848,32,569,13,85,
0500000US51580,"Covington city, Virginia",5653,2997,53.02%,46.98%,59.3,201,3.56%,217,96,38,1737,301,411,193,3538,604,1954,397,449,34.57%,7.02%,8%,179,5558,3.17%,96.83%,4541,716,12,32,5,11,
0500000US51590,"Danville city, Virginia",40668,21972,54.03%,45.97%,36.2,3909,9.61%,1345,1386,204,9532,2470,3157,2060,23681,5217,10877,3856,3361,26.75%,9.48%,8%,2074,40516,5.10%,94.90%,16884,21733,88,503,1,143,
0500000US51595,"Emporia city, Virginia",5408,3032,56.07%,43.94%,33.5,165,3.05%,124,146,0,1062,345,296,107,2595,403,1186,491,296,21.93%,9.08%,5%,345,5421,6.38%,93.62%,1529,3631,7,50,4,37,
0500000US51600,"Fairfax city, Virginia",23312,11937,51.21%,48.80%,54.9,1251,5.37%,445,936,581,2148,946,4656,5008,14839,9664,2593,1882,5237,11.12%,8.07%,22%,4278,19868,18.35%,81.65%,12911,1052,44,4519,9,204,
0500000US51610,"Falls Church city, Virginia",14309,7415,51.82%,48.18%,53.7,218,1.52%,168,501,273,639,243,3085,4666,9484,7751,807,744,3358,5.64%,5.20%,23%,1529,13129,10.69%,89.31%,9955,554,12,1494,10,117,
0500000US51620,"Franklin city, Virginia",8015,4364,54.45%,45.55%,45.8,651,8.12%,209,63,16,1804,717,758,323,4774,1081,2013,780,774,25.12%,9.73%,10%,218,7962,2.72%,97.28%,2966,4610,25,81,2,16,
0500000US51630,"Fredericksburg city, Virginia",29059,15727,54.12%,45.88%,38.7,1361,4.68%,913,3437,837,4098,959,4118,3341,16195,7459,5011,4396,4955,17.24%,15.13%,17%,3472,24510,11.95%,88.05%,15201,5956,86,1325,24,280,
0500000US51640,"Galax city, Virginia",6402,3494,54.58%,45.42%,49.9,361,5.64%,177,225,0,1206,358,423,323,3288,746,1383,583,423,21.60%,9.11%,7%,1061,5659,16.57%,83.43%,4975,354,13,52,0,15,
0500000US51650,"Hampton city, Virginia",135169,70086,51.85%,48.15%,40,9325,6.90%,5623,7682,1171,26813,9295,14559,9626,83223,24185,32436,16977,15730,24.00%,12.56%,12%,8411,128737,6.22%,93.78%,49389,66632,485,3493,209,895,
0500000US51660,"Harrisonburg city, Virginia",53558,27546,51.43%,48.57%,29.4,7779,14.52%,4381,11127,1579,7095,1733,5487,4164,22820,9651,11476,12860,7066,21.43%,24.01%,13%,12045,39769,22.49%,77.51%,31454,3906,71,2089,20,196,
0500000US51670,"Hopewell city, Virginia",22500,12171,54.09%,45.91%,41.9,2323,10.32%,1027,417,149,5422,1519,1329,579,12544,1908,6449,1936,1478,28.66%,8.60%,7%,1889,21144,8.40%,91.60%,9819,9689,86,251,15,129,
0500000US51678,"Lexington city, Virginia",7205,2990,41.50%,58.50%,24.1,663,9.20%,1255,1975,223,736,95,803,754,2857,1557,1991,2070,1026,27.63%,28.73%,14%,335,6985,4.65%,95.35%,6015,454,8,281,0,23,
0500000US51680,"Lynchburg city, Virginia",80970,43087,53.21%,46.79%,35.7,6111,7.55%,5620,10993,3011,11032,3718,9529,6796,40205,16325,16652,14711,12540,20.57%,18.17%,15%,3880,75129,4.79%,95.21%,47654,21228,200,1752,34,669,
0500000US51683,"Manassas city, Virginia",41038,20341,49.57%,50.43%,49.6,1350,3.29%,1457,1253,405,7108,2382,5212,3109,22770,8321,8565,3635,5617,20.87%,8.86%,14%,18345,24427,44.70%,55.30%,14816,4914,65,2703,19,317,
0500000US51685,"Manassas Park city, Virginia",17548,8455,48.18%,51.82%,45.4,391,2.23%,346,821,184,3104,1176,2086,811,8826,2897,3450,1997,2270,19.66%,11.38%,13%,7799,9420,44.44%,55.56%,4706,2076,27,1827,13,133,
0500000US51690,"Martinsville city, Virginia",12646,6950,54.96%,45.04%,39.4,1371,10.84%,178,492,105,2611,1238,1252,618,7454,1870,2789,1730,1357,22.05%,13.68%,11%,1025,12460,8.11%,91.89%,5732,6043,23,116,4,46,
0500000US51700,"Newport News city, Virginia",179582,92750,51.65%,48.35%,40.6,13209,7.36%,8448,9471,1903,32875,11853,20610,12104,106831,32714,41323,21324,22513,23.01%,11.87%,13%,19288,166959,10.74%,89.26%,71250,76870,571,6230,404,1124,
0500000US51710,"Norfolk city, Virginia",244300,116819,47.82%,52.18%,35.1,18835,7.71%,15588,22336,2917,38061,12784,28141,17914,135161,46055,53649,35120,31058,21.96%,14.38%,13%,23130,214875,9.47%,90.53%,97205,93553,832,8828,475,1331,
0500000US51720,"Norton city, Virginia",3969,2189,55.15%,44.85%,43.8,692,17.44%,129,181,12,985,185,320,277,2525,597,1114,366,332,28.07%,9.22%,8%,81,3606,2.04%,97.96%,3223,179,4,27,0,14,
0500000US51730,"Petersburg city, Virginia",30791,16744,54.38%,45.62%,25.6,3216,10.44%,935,1243,283,7500,1520,2735,1615,17882,4350,8435,2763,3018,27.39%,8.97%,10%,1970,31488,6.40%,93.60%,5178,24530,105,330,30,190,
0500000US51735,"Poquoson city, Virginia",12121,6150,50.74%,49.26%,65.5,278,2.29%,225,297,224,2014,826,1956,1745,8272,3701,2239,1123,2180,18.47%,9.26%,18%,463,11997,3.82%,96.18%,10937,107,33,253,2,67,
0500000US51740,"Portsmouth city, Virginia",94961,49135,51.74%,48.26%,37.1,7641,8.05%,3688,3785,601,19523,6267,8352,4884,56959,13236,23211,10052,8953,24.44%,10.59%,9%,4413,93502,4.65%,95.35%,34912,51586,355,1244,134,490,
0500000US51750,"Radford city, Virginia",17833,9582,53.73%,46.27%,21.5,3563,19.98%,1643,4724,1178,1717,621,1525,1831,7475,3356,3360,5345,2703,18.84%,29.97%,15%,765,15305,4.29%,95.71%,12006,2125,30,210,0,269,
0500000US51760,"Richmond city, Virginia",229233,120524,52.58%,47.42%,27.2,24882,10.85%,6907,14447,5078,34423,8322,38533,27903,140336,66436,41330,22769,43611,18.03%,9.93%,19%,23747,202863,10.36%,89.64%,95220,90490,440,6199,69,1378,
0500000US51770,"Roanoke city, Virginia",99122,52128,52.59%,47.41%,35.4,8220,8.29%,2312,2909,846,24599,6193,10387,6904,61191,17291,26911,9102,11233,27.15%,9.18%,11%,8484,91527,8.56%,91.44%,55951,27077,211,2462,42,523,
0500000US51775,"Salem city, Virginia",25290,13292,52.56%,47.44%,44.6,996,3.94%,942,2022,169,4786,2213,3088,2147,15715,5235,5728,4235,3257,22.65%,16.75%,13%,1088,24258,4.30%,95.70%,20673,1913,42,534,5,66,
0500000US51790,"Staunton city, Virginia",24660,13378,54.25%,45.75%,44.1,1022,4.14%,785,1007,306,5211,1280,3001,2505,15880,5506,5996,2287,3307,24.31%,9.27%,13%,1088,24662,4.41%,95.59%,19959,2882,65,320,11,155,
0500000US51800,"Suffolk city, Virginia",91383,47198,51.65%,48.35%,53.5,3920,4.29%,2506,3119,578,16132,5648,10899,7490,56002,18389,18638,8767,11477,20.40%,9.59%,13%,4252,90072,4.65%,95.35%,43837,39194,255,1672,68,543,
0500000US51810,"Virginia Beach city, Virginia",450882,229356,50.87%,49.13%,51.7,15813,3.51%,15208,18598,4765,64167,34519,72697,42494,290613,115191,79375,53117,77462,17.60%,11.78%,17%,40404,419066,8.96%,91.04%,269566,82583,1184,33756,671,2599,
0500000US51820,"Waynesboro city, Virginia",22300,11450,51.35%,48.66%,42.6,1687,7.57%,778,470,180,5216,1100,2510,2027,13665,4537,5994,1570,2690,26.88%,7.04%,12%,1945,20251,8.72%,91.28%,16074,2610,33,258,20,104,
0500000US51830,"Williamsburg city, Virginia",15034,8019,53.34%,46.66%,25.4,1199,7.98%,631,4616,369,1498,577,1976,1917,7168,3893,2129,5193,2345,14.16%,34.54%,16%,1215,14210,8.08%,91.92%,7370,5648,20,497,25,53,
0500000US51840,"Winchester city, Virginia",27912,14268,51.12%,48.88%,39.5,1404,5.03%,1217,1054,175,4628,1307,3777,2620,16079,6397,5845,2361,3952,20.94%,8.46%,14%,5494,22626,19.68%,80.32%,17623,2800,66,700,14,135,
0500000US53001,"Adams County, Washington",19702,9615,48.80%,51.20%,50.1,2202,11.18%,974,345,124,3415,649,900,589,7426,1489,4389,994,1024,22.28%,5.05%,5%,13120,7493,66.59%,33.41%,6829,24,63,129,3,87,
0500000US53003,"Asotin County, Washington",22636,11612,51.30%,48.70%,50,1360,6.01%,443,641,207,4488,2042,2472,1343,14853,3815,4931,2683,2679,21.78%,11.85%,12%,915,21370,4.04%,95.96%,19473,113,262,206,34,88,
0500000US53005,"Benton County, Washington",200715,100303,49.97%,50.03%,52.3,9197,4.58%,5740,6757,1412,30783,13547,25180,16009,118696,41189,36523,20304,26592,18.20%,10.12%,13%,49339,157534,24.58%,75.42%,135718,2621,1191,6244,536,1049,
0500000US53007,"Chelan County, Washington",76653,38104,49.71%,50.29%,52.4,3449,4.50%,1710,2913,438,13392,5290,8718,5120,43907,13838,15102,8203,9156,19.70%,10.70%,12%,22104,56970,28.84%,71.16%,52093,253,408,787,109,381,
0500000US53009,"Clallam County, Washington",76482,38854,50.80%,49.20%,50.1,4087,5.34%,1825,1886,179,15335,6223,10313,6672,54236,16985,17160,8109,10492,22.44%,10.60%,14%,4732,72423,6.19%,93.81%,61164,571,3931,1234,113,432,
0500000US53011,"Clark County, Washington",481950,243747,50.58%,49.43%,53.5,19666,4.08%,14730,15177,3109,79977,35916,66597,36110,304719,102707,94707,51093,69706,19.65%,10.60%,14%,58790,444521,12.20%,87.80%,366727,10850,3051,23910,5127,2536,
0500000US53013,"Columbia County, Washington",4024,2050,50.94%,49.06%,63.3,100,2.49%,77,180,13,583,440,387,382,2678,769,660,620,400,16.40%,15.41%,10%,304,3648,7.55%,92.45%,3347,6,41,21,0,18,
0500000US53015,"Cowlitz County, Washington",108399,54547,50.32%,49.68%,49.8,6092,5.62%,3005,3292,235,22931,9211,8637,4187,67878,12824,25936,12503,8872,23.93%,11.53%,8%,10802,99928,9.97%,90.03%,88067,746,1409,1721,643,485,
0500000US53017,"Douglas County, Washington",42520,21084,49.59%,50.41%,55.1,1820,4.28%,1353,1275,161,8219,2659,3871,1927,23241,5798,9572,3934,4032,22.51%,9.25%,9%,14637,28301,34.42%,65.58%,25445,117,338,406,55,203,
0500000US53019,"Ferry County, Washington",7643,3792,49.61%,50.39%,49.6,562,7.35%,204,112,7,2106,478,805,468,5397,1273,2310,590,812,30.22%,7.72%,11%,210,6968,2.75%,97.25%,5056,21,1293,43,11,36,
0500000US53021,"Franklin County, Washington",93681,45442,48.51%,51.49%,50.7,4896,5.23%,2870,3692,305,13699,5210,6449,3836,41614,10285,16569,8902,6754,17.69%,9.50%,7%,52445,44304,55.98%,44.02%,37225,1603,437,1796,195,338,
0500000US53023,"Garfield County, Washington",2258,1097,48.58%,51.42%,70.9,82,3.63%,65,18,5,470,255,292,146,1628,438,535,273,297,23.69%,12.09%,13%,110,2176,4.87%,95.13%,2055,3,18,9,0,5,
0500000US53025,"Grant County, Washington",96648,47617,49.27%,50.73%,49.7,5204,5.38%,4287,2724,666,15952,5464,7681,2921,46272,10602,20239,8188,8347,20.94%,8.47%,9%,42401,56722,43.87%,56.13%,50250,651,830,1153,96,397,
0500000US53027,"Grays Harbor County, Washington",73769,35889,48.65%,51.35%,50.4,4959,6.72%,2242,1762,325,19068,6133,5673,2975,48302,8648,21310,7895,5998,28.89%,10.70%,8%,7834,67802,10.62%,89.38%,57068,972,3495,1024,127,411,
0500000US53029,"Island County, Washington",84187,42198,50.12%,49.88%,59.8,3079,3.66%,3202,2923,376,13521,7040,12485,8520,58822,21005,16723,9963,12861,19.86%,11.83%,15%,7118,79739,8.45%,91.55%,65856,2265,543,3916,414,562,
0500000US53031,"Jefferson County, Washington",31825,16268,51.12%,48.88%,56.7,1991,6.26%,641,368,99,5653,1982,6201,5142,25687,11343,6294,2350,6300,19.78%,7.38%,20%,1305,31672,4.10%,95.90%,28216,207,522,487,49,229,
0500000US53033,"King County, Washington",2225064,1107557,49.78%,50.22%,49.8,87585,3.94%,46029,73278,41642,236791,126898,505955,345863,1489884,851818,282820,200176,547597,12.71%,9.00%,25%,243021,2026654,10.92%,89.08%,1230588,147831,11810,449729,19399,13538,
0500000US53035,"Kitsap County, Washington",268945,131359,48.84%,51.16%,54.3,9660,3.59%,11065,10566,1749,40056,20504,42364,22330,178423,64694,51121,31070,44113,19.01%,11.55%,16%,24184,251427,8.99%,91.01%,199020,7338,3491,14015,2814,1782,
0500000US53037,"Kittitas County, Washington",47097,23550,50.00%,50.00%,45.1,3369,7.15%,2135,6327,1212,7176,2177,6599,3243,26537,9842,9311,8504,7811,19.77%,18.06%,17%,4594,39743,9.75%,90.25%,35323,380,407,907,87,246,
0500000US53039,"Klickitat County, Washington",22055,10882,49.34%,50.66%,53.3,1197,5.43%,557,381,105,4237,1413,3142,1872,14612,5014,4794,1794,3247,21.74%,8.13%,15%,2913,19822,13.21%,86.79%,17731,64,503,135,35,113,
0500000US53041,"Lewis County, Washington",79430,39667,49.94%,50.06%,51.7,4388,5.52%,2105,2534,193,16736,6945,6899,3869,50433,10768,18841,9479,7092,23.72%,11.93%,9%,8830,73319,11.12%,88.88%,65496,530,978,796,157,403,
0500000US53043,"Lincoln County, Washington",10732,5347,49.82%,50.18%,64.8,437,4.07%,228,340,20,2106,875,1308,663,7212,1971,2334,1215,1328,21.75%,11.32%,12%,385,10491,3.59%,96.41%,9576,15,204,67,14,57,
0500000US53045,"Mason County, Washington",65326,31386,48.05%,51.96%,49.4,4043,6.19%,2073,1243,148,15023,5782,6123,2572,42974,8695,17096,7025,6271,26.17%,10.75%,10%,7595,58131,11.63%,88.37%,49591,688,1959,758,216,422,
0500000US53047,"Okanogan County, Washington",42080,20811,49.46%,50.54%,53.9,3037,7.22%,1368,687,109,8743,2684,3825,2143,24950,5968,10111,3371,3934,24.03%,8.01%,9%,8197,33907,19.48%,80.52%,26522,159,4588,268,40,271,
0500000US53049,"Pacific County, Washington",22121,11127,50.30%,49.70%,53.7,1522,6.88%,421,496,122,5190,1729,2336,1168,15524,3504,5611,2225,2458,25.37%,10.06%,11%,2196,21169,9.93%,90.07%,18609,100,501,461,39,119,
0500000US53051,"Pend Oreille County, Washington",13588,6662,49.03%,50.97%,55,637,4.69%,390,286,49,3267,1106,1354,768,9133,2122,3657,1392,1403,26.91%,10.24%,10%,448,12953,3.30%,96.70%,11684,54,373,69,9,65,
0500000US53053,"Pierce County, Washington",891862,446883,50.11%,49.89%,50.4,43351,4.86%,31107,32125,7190,159765,70337,108315,58335,552801,166650,190872,102462,115505,21.40%,11.49%,13%,111811,809319,12.54%,87.46%,569815,63059,9642,62126,18182,5560,
0500000US53055,"San Juan County, Washington",16953,8740,51.55%,48.45%,59.2,917,5.41%,331,295,41,2121,850,4154,3024,13327,7178,2452,1145,4195,14.46%,6.75%,25%,1298,16490,7.66%,92.34%,15024,48,92,224,23,122,
0500000US53057,"Skagit County, Washington",127442,64376,50.51%,49.49%,54.2,6488,5.09%,3614,3745,498,23024,10122,15766,8925,81522,24691,26638,13867,16264,20.90%,10.88%,13%,23792,105731,18.67%,81.33%,92347,793,2052,2771,388,723,
0500000US53059,"Skamania County, Washington",11906,6001,50.40%,49.60%,58,547,4.59%,233,319,28,2723,854,1417,924,8263,2341,2956,1173,1445,24.83%,9.85%,12%,765,11271,6.43%,93.57%,10060,72,170,120,29,79,
0500000US53061,"Snohomish County, Washington",811572,404812,49.88%,50.12%,53.1,27669,3.41%,22145,23813,6887,133655,62474,125052,60294,523575,185346,155800,86287,131939,19.20%,10.63%,16%,95644,732313,11.79%,88.21%,528415,28392,7993,100654,4851,4805,
0500000US53063,"Spokane County, Washington",513402,258611,50.37%,49.63%,49.1,29790,5.80%,14959,23841,4327,80649,45962,71161,40197,331342,111358,95608,69803,75488,18.62%,13.60%,15%,35350,503989,6.89%,93.11%,431806,10486,6862,12404,4202,2644,
0500000US53065,"Stevens County, Washington",45233,22710,50.21%,49.79%,56.5,1984,4.39%,1426,878,130,11149,3272,4045,2610,29798,6655,12575,4150,4175,27.80%,9.17%,9%,1685,44760,3.73%,96.27%,38722,141,2558,280,84,288,
0500000US53067,"Thurston County, Washington",284698,145369,51.06%,48.94%,52.7,13472,4.73%,8136,9624,1941,43782,22098,44566,27219,188570,71785,51918,31722,46507,18.24%,11.14%,16%,29024,265769,10.19%,89.81%,207985,8893,3621,16878,3241,1782,
0500000US53069,"Wahkiakum County, Washington",4318,2219,51.39%,48.61%,66.5,145,3.36%,102,76,0,952,496,389,292,3110,681,1054,572,389,24.41%,13.25%,9%,183,4239,4.24%,95.76%,3817,21,55,43,2,24,
0500000US53071,"Walla Walla County, Washington",60785,29659,48.79%,51.21%,49.5,2452,4.03%,2327,4314,448,8304,4774,6557,4903,35180,11460,10631,9088,7005,17.49%,14.95%,12%,14206,48378,23.37%,76.63%,42580,981,418,918,134,280,
0500000US53073,"Whatcom County, Washington",224538,113685,50.63%,49.37%,48.4,14163,6.31%,8329,17151,3605,33284,16387,33144,19686,138809,52830,41613,33538,36749,18.53%,14.94%,16%,22825,204022,10.17%,89.83%,170385,2221,5459,9952,672,1338,
0500000US53075,"Whitman County, Washington",49577,24322,49.06%,50.94%,35.2,6852,13.82%,3128,12165,1637,3946,2632,6206,5816,23822,12022,7074,14797,7843,14.27%,29.85%,16%,4052,43921,8.17%,91.83%,35557,1163,266,3616,139,258,
0500000US53077,"Yakima County, Washington",250649,125504,50.07%,49.93%,48.9,16797,6.70%,8876,7328,1034,41418,13024,16611,10226,113211,26837,50294,20352,17645,20.07%,8.12%,7%,130049,126679,51.88%,48.12%,103578,1718,9357,2785,221,1045,
0500000US54001,"Barbour County, West Virginia",16543,8480,51.26%,48.74%,47.1,1558,9.42%,1002,707,61,5724,969,955,618,9878,1573,6726,1676,1016,40.66%,10.13%,6%,192,15273,1.16%,98.84%,14379,259,37,32,0,10,
0500000US54003,"Berkeley County, West Virginia",117615,59623,50.69%,49.31%,51.3,5868,4.99%,3534,3135,964,30397,6834,11748,6794,73408,18542,33931,9969,12712,28.85%,8.48%,11%,6893,115183,5.86%,94.14%,96559,9118,284,1445,43,511,
0500000US54005,"Boone County, West Virginia",21897,10957,50.04%,49.96%,54.7,1512,6.91%,458,736,85,7286,1348,1035,787,13046,1822,7744,2084,1120,35.37%,9.52%,5%,133,21676,0.61%,99.39%,20712,135,39,36,2,18,
0500000US54007,"Braxton County, West Virginia",14032,6986,49.79%,50.21%,52.9,827,5.89%,502,237,63,4887,557,1030,422,8471,1452,5389,794,1093,38.41%,5.66%,8%,85,12362,0.61%,99.39%,11939,50,19,23,11,15,
0500000US54009,"Brooke County, West Virginia",22162,11219,50.62%,49.38%,46.8,1179,5.32%,898,1041,81,6613,1686,2123,1127,14825,3250,7511,2727,2204,33.89%,12.30%,10%,287,22272,1.30%,98.70%,20792,365,36,55,0,70,
0500000US54011,"Cabell County, West Virginia",93328,47704,51.11%,48.89%,42.9,9326,9.99%,3582,5889,1781,20402,5007,9572,7353,55100,16925,23984,10896,11353,25.70%,11.67%,12%,1562,92788,1.67%,98.33%,82095,4751,185,1328,20,298,
0500000US54013,"Calhoun County, West Virginia",7185,3659,50.93%,49.07%,52.8,782,10.88%,212,135,31,2478,191,498,165,4488,663,2690,326,529,37.44%,4.54%,7%,48,6181,0.67%,99.33%,5976,13,12,12,2,2,
0500000US54015,"Clay County, West Virginia",8599,4263,49.58%,50.42%,51.2,1218,14.16%,313,148,124,3111,243,274,333,4591,607,3424,391,398,39.82%,4.55%,5%,52,7999,0.60%,99.40%,7651,11,29,13,0,1,
0500000US54017,"Doddridge County, West Virginia",8499,3829,45.05%,54.95%,54,204,2.40%,310,249,151,2790,521,718,324,5165,1042,3100,770,869,36.47%,9.06%,10%,77,7731,0.91%,99.09%,7290,174,15,15,0,15,
0500000US54019,"Fayette County, West Virginia",43087,21420,49.71%,50.29%,51.8,2976,6.91%,1395,1109,258,13633,2311,3211,1540,26349,4751,15028,3420,3469,34.88%,7.94%,8%,525,39963,1.22%,98.78%,36308,1662,100,105,1,114,
0500000US54021,"Gilmer County, West Virginia",7970,3337,41.87%,58.13%,41.1,327,4.10%,455,581,205,2571,311,551,381,4606,932,3026,892,756,37.97%,11.19%,9%,244,7164,3.06%,96.94%,6026,923,11,30,0,1,
0500000US54023,"Grant County, West Virginia",11565,5728,49.53%,50.47%,50.7,617,5.34%,420,265,69,4012,544,747,331,7063,1078,4432,809,816,38.32%,7.00%,7%,91,10885,0.79%,99.21%,10463,83,21,24,0,20,
0500000US54025,"Greenbrier County, West Virginia",34893,17901,51.30%,48.70%,48.5,2812,8.06%,1442,614,100,9717,2131,3232,1950,22121,5182,11159,2745,3332,31.98%,7.87%,10%,571,32406,1.64%,98.36%,30199,766,55,192,5,88,
0500000US54027,"Hampshire County, West Virginia",23304,11359,48.74%,51.26%,51.1,648,2.78%,636,648,176,8233,1295,1277,840,14948,2117,8869,1943,1453,38.06%,8.34%,6%,337,22756,1.45%,98.55%,21655,178,30,61,4,74,
0500000US54029,"Hancock County, West Virginia",29118,14945,51.33%,48.67%,48.3,1765,6.06%,764,710,227,8613,2476,2231,1296,19323,3527,9377,3186,2458,32.20%,10.94%,8%,424,28671,1.46%,98.54%,26484,695,31,110,8,74,
0500000US54031,"Hardy County, West Virginia",13789,6651,48.23%,51.77%,59.4,741,5.37%,322,318,5,4756,736,769,626,8147,1395,5078,1054,774,36.83%,7.64%,6%,659,13640,4.78%,95.22%,12685,403,16,53,0,31,
0500000US54033,"Harrison County, West Virginia",67620,34603,51.17%,48.83%,49.7,3676,5.44%,1920,1734,532,19220,3590,6877,4259,42788,11136,21140,5324,7409,31.26%,7.87%,11%,1403,64518,2.07%,97.93%,59862,1104,135,489,28,152,
0500000US54035,"Jackson County, West Virginia",28793,14434,50.13%,49.87%,53.8,1196,4.15%,792,724,159,8954,2213,2048,1647,18193,3695,9746,2937,2207,33.85%,10.20%,8%,230,27561,0.80%,99.20%,26411,100,43,91,2,62,
0500000US54037,"Jefferson County, West Virginia",56922,28870,50.72%,49.28%,52.6,2352,4.13%,1469,2352,537,12158,2881,7558,4948,35826,12506,13627,5233,8095,23.94%,9.19%,14%,4137,53564,7.27%,92.73%,45784,3379,104,817,10,304,
0500000US54039,"Kanawha County, West Virginia",181014,93841,51.84%,48.16%,46.7,14146,7.81%,5452,5220,843,48066,9291,20815,13797,117214,34612,53518,14511,21658,29.57%,8.02%,12%,2720,178025,1.50%,98.50%,152735,13416,357,2138,47,733,
0500000US54041,"Lewis County, West Virginia",16024,8002,49.94%,50.06%,51.1,1441,8.99%,618,310,64,5488,600,1135,668,9988,1803,6106,910,1199,38.11%,5.68%,7%,191,16842,1.19%,98.81%,16088,66,19,58,7,23,
0500000US54043,"Lincoln County, West Virginia",20617,10375,50.32%,49.68%,59.6,2016,9.78%,881,321,0,6667,1027,846,287,11704,1133,7548,1348,846,36.61%,6.54%,4%,171,20292,0.83%,99.17%,19702,44,22,26,0,21,
0500000US54045,"Logan County, West Virginia",32593,16549,50.78%,49.23%,54.8,4191,12.86%,1122,746,70,10232,1735,1552,1359,18909,2911,11354,2481,1622,34.84%,7.61%,5%,224,32343,0.69%,99.31%,30785,580,41,63,1,34,
0500000US54047,"McDowell County, West Virginia",18083,8896,49.20%,50.81%,45.6,2811,15.54%,566,227,0,6329,369,588,321,9595,909,6895,596,588,38.13%,3.30%,3%,390,18721,2.16%,97.84%,15871,2139,20,20,4,45,
0500000US54049,"Marion County, West Virginia",56233,28367,50.45%,49.56%,50.6,3510,6.24%,2176,3014,554,15663,3191,5609,3316,34904,8925,17839,6205,6163,31.72%,11.03%,11%,875,55330,1.56%,98.44%,50223,1844,119,256,43,116,
0500000US54051,"Marshall County, West Virginia",30900,15570,50.39%,49.61%,49.5,1691,5.47%,1110,613,128,10154,2381,2386,1847,21058,4233,11264,2994,2514,36.45%,9.69%,8%,354,30237,1.15%,98.85%,28669,260,34,108,7,64,
0500000US54053,"Mason County, West Virginia",26700,13745,51.48%,48.52%,57.8,1835,6.87%,819,540,152,8201,2110,2233,1071,16734,3304,9020,2650,2385,33.78%,9.93%,9%,170,25283,0.64%,99.36%,24322,193,32,74,5,20,
0500000US54055,"Mercer County, West Virginia",59370,30992,52.20%,47.80%,49.2,3751,6.32%,1839,2214,371,16277,2570,5656,2807,35470,8463,18116,4784,6027,30.51%,8.06%,10%,705,58959,1.19%,98.81%,52264,3694,159,292,6,139,
0500000US54057,"Mineral County, West Virginia",27047,13493,49.89%,50.11%,52.1,1595,5.90%,821,1238,116,9167,1841,1957,1454,17915,3411,9988,3079,2073,36.93%,11.38%,8%,309,26629,1.14%,98.86%,24603,711,36,113,5,50,
0500000US54059,"Mingo County, West Virginia",23808,12132,50.96%,49.04%,54.7,3284,13.79%,615,672,20,7586,896,880,809,12944,1689,8201,1568,900,34.45%,6.59%,4%,164,23404,0.69%,99.31%,22293,405,33,32,0,33,
0500000US54061,"Monongalia County, West Virginia",106196,51776,48.76%,51.25%,38.7,12428,11.70%,4594,13733,3375,17750,4607,13899,15091,61630,28990,22344,18340,17274,21.04%,17.27%,16%,3308,102514,3.11%,96.89%,88959,4068,147,3729,63,382,
0500000US54063,"Monroe County, West Virginia",13344,6514,48.82%,51.18%,53.2,834,6.25%,527,204,0,5077,440,971,562,8638,1533,5604,644,971,42.00%,4.83%,7%,94,12282,0.70%,99.30%,11739,113,26,11,0,30,
0500000US54065,"Morgan County, West Virginia",17800,8926,50.15%,49.85%,56.9,424,2.38%,512,542,35,5646,985,1292,1205,11832,2497,6158,1527,1327,34.60%,8.58%,7%,236,16827,1.33%,98.67%,15896,108,30,83,0,53,
0500000US54067,"Nicholas County, West Virginia",24857,12496,50.27%,49.73%,57.3,1703,6.85%,843,482,50,8800,926,1752,1477,16060,3229,9643,1408,1802,38.79%,5.66%,7%,173,24431,0.70%,99.30%,23525,56,44,72,7,15,
0500000US54069,"Ohio County, West Virginia",41875,21751,51.94%,48.06%,44,2342,5.59%,1045,2627,353,10200,2141,5652,3655,27354,9307,11245,4768,6005,26.85%,11.39%,14%,647,41778,1.55%,98.45%,37559,1656,67,387,20,134,
0500000US54071,"Pendleton County, West Virginia",6968,3378,48.48%,51.52%,61.8,451,6.47%,192,178,14,2563,265,672,287,4321,959,2755,443,686,39.54%,6.36%,10%,57,6086,0.82%,99.18%,5835,81,7,0,2,13,
0500000US54073,"Pleasants County, West Virginia",7457,3407,45.69%,54.31%,52.9,274,3.67%,347,212,83,2736,437,367,197,4710,564,3083,649,450,41.34%,8.70%,6%,63,7590,0.84%,99.16%,7215,95,22,17,0,10,
0500000US54075,"Pocahontas County, West Virginia",8382,4163,49.67%,50.33%,49.4,456,5.44%,200,144,41,3026,460,557,317,5430,874,3226,604,598,38.49%,7.21%,7%,107,7762,1.28%,98.72%,7455,51,23,9,0,25,
0500000US54077,"Preston County, West Virginia",33610,16273,48.42%,51.58%,53,2171,6.46%,1263,371,202,12274,1197,2497,1565,21664,4062,13537,1568,2699,40.28%,4.67%,8%,695,33521,2.07%,97.93%,30348,2001,69,53,5,37,
0500000US54079,"Putnam County, West Virginia",56604,28712,50.72%,49.28%,56.3,3023,5.34%,1952,1379,355,14592,3466,6359,4113,36755,10472,16544,4845,6714,29.23%,8.56%,12%,811,56629,1.43%,98.57%,53139,646,81,577,7,152,
0500000US54081,"Raleigh County, West Virginia",74452,37239,50.02%,49.98%,53,6992,9.39%,2292,2336,345,20732,3951,6746,3875,46779,10621,23024,6287,7091,30.92%,8.44%,10%,1197,73394,1.61%,98.39%,63510,5790,132,819,16,156,
0500000US54083,"Randolph County, West Virginia",28763,14013,48.72%,51.28%,46.4,1618,5.63%,975,901,96,10506,1104,2120,1163,18130,3283,11481,2005,2216,39.92%,6.97%,8%,312,27620,1.08%,98.92%,26033,424,56,96,1,85,
0500000US54085,"Ritchie County, West Virginia",9747,4892,50.19%,49.81%,61.5,807,8.28%,325,172,9,3398,645,558,289,5990,847,3723,817,567,38.20%,8.38%,6%,80,8364,0.82%,99.18%,8116,16,6,19,7,8,
0500000US54087,"Roane County, West Virginia",13831,6991,50.55%,49.45%,52.2,1361,9.84%,459,150,129,4385,874,725,567,8093,1292,4844,1024,854,35.02%,7.40%,6%,152,13876,1.10%,98.90%,13231,35,28,38,0,9,
0500000US54089,"Summers County, West Virginia",12710,6859,53.97%,46.04%,52.4,736,5.79%,391,154,0,4250,397,935,659,8504,1594,4641,551,935,36.51%,4.34%,7%,185,11774,1.46%,98.54%,10823,400,33,33,0,21,
0500000US54091,"Taylor County, West Virginia",16817,8483,50.44%,49.56%,50,1294,7.69%,417,342,146,5422,802,1524,810,11270,2334,5839,1144,1670,34.72%,6.80%,10%,179,16526,1.06%,98.94%,15636,112,19,41,0,22,
0500000US54093,"Tucker County, West Virginia",6943,3452,49.72%,50.28%,54.8,381,5.49%,167,137,41,2476,333,583,467,4750,1050,2643,470,624,38.07%,6.77%,9%,56,6706,0.81%,99.19%,6432,20,4,6,1,10,
0500000US54095,"Tyler County, West Virginia",8736,4348,49.77%,50.23%,51.5,643,7.36%,306,199,12,2938,697,724,320,5759,1044,3244,896,736,37.13%,10.26%,8%,53,8260,0.61%,99.39%,7964,4,15,3,0,13,
0500000US54097,"Upshur County, West Virginia",24451,12326,50.41%,49.59%,43.5,2022,8.27%,1287,1067,120,8574,1028,1676,1043,14565,2719,9861,2095,1796,40.33%,8.57%,7%,316,23500,1.29%,98.71%,22349,211,37,87,5,28,
0500000US54099,"Wayne County, West Virginia",39952,20571,51.49%,48.51%,51.7,3433,8.59%,1211,990,121,11126,1979,2940,2114,23416,5054,12337,2969,3061,30.88%,7.43%,8%,319,38663,0.80%,99.20%,37199,168,53,83,10,56,
0500000US54101,"Webster County, West Virginia",8289,4212,50.81%,49.19%,51,699,8.43%,181,308,6,2764,242,364,263,4581,627,2945,550,370,35.53%,6.64%,4%,50,8328,0.60%,99.40%,8086,10,14,4,2,7,
0500000US54103,"Wetzel County, West Virginia",15291,7900,51.66%,48.34%,47.7,1282,8.38%,553,445,41,5294,841,937,456,9576,1393,5847,1286,978,38.24%,8.41%,6%,148,14294,0.97%,99.03%,13704,34,18,50,0,11,
0500000US54105,"Wirt County, West Virginia",5764,2867,49.74%,50.26%,65.6,248,4.30%,71,86,36,1741,344,280,181,3611,461,1812,430,316,31.44%,7.46%,5%,22,5172,0.38%,99.62%,4999,6,4,0,4,8,
0500000US54107,"Wood County, West Virginia",84387,43634,51.71%,48.29%,50,4945,5.86%,2458,2479,537,20414,6840,8264,4968,54792,13232,22872,9319,8801,27.10%,11.04%,10%,1174,83122,1.39%,98.61%,77718,1016,148,564,17,209,
0500000US54109,"Wyoming County, West Virginia",20890,10570,50.60%,49.40%,62.6,1734,8.30%,646,295,57,7074,884,1093,706,11857,1799,7720,1179,1150,36.96%,5.64%,6%,170,21212,0.81%,99.19%,20539,107,30,11,1,20,
0500000US55001,"Adams County, Wisconsin",20208,9304,46.04%,53.96%,55.4,785,3.88%,575,206,65,6680,1332,1706,688,14175,2394,7255,1538,1771,35.90%,7.61%,9%,797,19857,3.94%,96.06%,18372,593,165,84,8,60,
0500000US55003,"Ashland County, Wisconsin",15524,7611,49.03%,50.97%,46.7,1094,7.05%,487,614,94,3953,1423,1393,654,9939,2047,4440,2037,1487,28.60%,13.12%,10%,383,15644,2.47%,97.53%,12678,112,1999,82,9,22,
0500000US55005,"Barron County, Wisconsin",45182,22431,49.65%,50.35%,56.6,2035,4.50%,1432,1152,182,11532,4483,4480,2155,29121,6635,12964,5635,4662,28.69%,12.47%,10%,1277,45434,2.83%,97.17%,42210,813,436,345,5,99,
0500000US55007,"Bayfield County, Wisconsin",15088,7399,49.04%,50.96%,62,726,4.81%,248,371,131,3254,1433,2388,1328,11087,3716,3502,1804,2519,23.21%,11.96%,17%,279,15941,1.85%,98.15%,13445,54,1612,36,2,56,
0500000US55009,"Brown County, Wisconsin",262559,132341,50.40%,49.60%,51.2,10094,3.84%,7803,10442,3375,52634,22354,37418,15976,162799,53394,60437,32796,40793,23.02%,12.49%,16%,26216,242524,9.98%,90.02%,208440,8154,6329,8445,114,637,
0500000US55011,"Buffalo County, Wisconsin",13087,6443,49.23%,50.77%,59.3,298,2.28%,348,287,77,3806,1384,1267,560,8764,1827,4154,1671,1344,31.74%,12.77%,10%,327,12990,2.50%,97.50%,12577,43,31,19,12,8,
0500000US55013,"Burnett County, Wisconsin",15363,7490,48.75%,51.25%,57.2,779,5.07%,329,302,78,4367,1371,1753,739,11006,2492,4696,1673,1831,30.57%,10.89%,12%,254,16272,1.65%,98.35%,14658,65,697,53,10,32,
0500000US55015,"Calumet County, Wisconsin",50005,24845,49.69%,50.32%,64.2,1171,2.34%,1256,1459,519,10995,4992,7721,2587,32718,10308,12251,6451,8240,24.50%,12.90%,16%,2857,49585,5.71%,94.29%,46056,419,189,1269,42,124,
0500000US55017,"Chippewa County, Wisconsin",64175,30901,48.15%,51.85%,55.5,2477,3.86%,1787,1546,342,15321,7312,7025,3041,42301,10066,17108,8858,7367,26.66%,13.80%,11%,1257,65040,1.96%,98.04%,60391,1040,323,959,14,153,
0500000US55019,"Clark County, Wisconsin",34668,17150,49.47%,50.53%,57.3,1835,5.29%,907,694,92,8693,2268,2105,809,17988,2914,9600,2962,2197,27.69%,8.54%,6%,2098,32561,6.05%,93.95%,31566,103,117,106,4,72,
0500000US55021,"Columbia County, Wisconsin",57331,27873,48.62%,51.38%,56.3,1878,3.28%,1616,1283,575,13341,5134,6739,3130,38139,9869,14957,6417,7314,26.09%,11.19%,13%,2139,56351,3.73%,96.27%,53037,866,270,376,11,122,
0500000US55023,"Crawford County, Wisconsin",16155,7768,48.08%,51.92%,51.3,911,5.64%,532,335,87,4609,1302,1561,664,10784,2225,5141,1637,1648,31.82%,10.13%,10%,260,15853,1.61%,98.39%,15018,265,41,68,1,34,
0500000US55025,"Dane County, Wisconsin",542459,272699,50.27%,49.73%,46.4,31450,5.80%,16688,34902,18445,61911,34976,112116,75811,344809,187927,78599,69878,130561,14.49%,12.88%,24%,41954,519550,7.73%,92.27%,426721,29742,1275,35592,214,2103,
0500000US55027,"Dodge County, Wisconsin",87569,41823,47.76%,52.24%,50.6,2862,3.27%,2704,2192,542,25610,7621,7993,3473,58114,11466,28314,9813,8535,32.33%,11.21%,10%,5490,83906,6.27%,93.73%,77845,2701,371,511,11,204,
0500000US55029,"Door County, Wisconsin",27621,13960,50.54%,49.46%,63.4,1018,3.69%,414,616,130,6559,1944,4973,2535,20673,7508,6973,2560,5103,25.25%,9.27%,18%,1138,28928,4.12%,95.88%,27524,140,122,136,0,76,
0500000US55031,"Douglas County, Wisconsin",43497,21605,49.67%,50.33%,49,1756,4.04%,1119,2026,227,8935,4227,5365,2676,29218,8041,10054,6253,5592,23.11%,14.38%,13%,768,43527,1.77%,98.23%,39417,576,763,286,18,139,
0500000US55033,"Dunn County, Wisconsin",45029,22451,49.86%,50.14%,44.8,2025,4.50%,1982,5780,631,8851,3143,5337,2838,25741,8175,10833,8923,5968,24.06%,19.82%,13%,1035,44405,2.30%,97.70%,40912,388,157,1451,13,88,
0500000US55035,"Eau Claire County, Wisconsin",104132,52535,50.45%,49.55%,46.3,6671,6.41%,4433,10106,1396,16970,10168,14580,7426,62898,22006,21403,20274,15976,20.55%,19.47%,15%,3118,102592,2.99%,97.01%,92354,1213,440,4365,83,251,
0500000US55037,"Florence County, Wisconsin",4312,2100,48.70%,51.30%,60.3,155,3.59%,93,53,37,1257,412,538,198,3213,736,1350,465,575,31.31%,10.78%,13%,66,4492,1.53%,98.47%,4296,9,30,5,4,11,
0500000US55039,"Fond du Lac County, Wisconsin",102654,51857,50.52%,49.48%,55.6,2981,2.90%,3351,4160,716,25629,8613,11257,5883,66265,17140,28980,12773,11973,28.23%,12.44%,12%,6717,97437,6.54%,93.46%,90150,2321,355,1241,31,214,
0500000US55041,"Forest County, Wisconsin",9003,4473,49.68%,50.32%,52.4,748,8.31%,288,263,29,2533,745,696,289,5821,985,2821,1008,725,31.33%,11.20%,8%,155,9024,1.72%,98.28%,7371,32,1187,17,7,3,
0500000US55043,"Grant County, Wisconsin",51570,24838,48.16%,51.84%,49.2,3455,6.70%,2033,5841,260,11103,4493,4630,2783,29384,7413,13136,10334,4890,25.47%,20.04%,9%,1236,50702,2.40%,97.60%,48325,679,95,411,8,58,
0500000US55045,"Green County, Wisconsin",36790,18486,50.25%,49.75%,53.9,1286,3.50%,952,1160,139,9187,3315,4198,1904,24135,6102,10139,4475,4337,27.56%,12.16%,12%,1500,35593,4.08%,95.92%,33960,201,49,170,3,76,
0500000US55047,"Green Lake County, Wisconsin",18807,9313,49.52%,50.48%,56.2,886,4.71%,535,469,70,5202,1240,1933,848,12051,2781,5737,1709,2003,30.50%,9.09%,11%,979,18039,5.21%,94.79%,17255,106,49,101,0,39,
0500000US55049,"Iowa County, Wisconsin",23632,11733,49.65%,50.35%,56.8,792,3.35%,517,753,130,5703,2009,2749,1461,15906,4210,6220,2762,2879,26.32%,11.69%,12%,455,23254,1.93%,98.07%,22203,114,26,178,12,50,
0500000US55051,"Iron County, Wisconsin",5679,2820,49.66%,50.34%,54.3,314,5.53%,82,166,3,1477,713,737,259,4349,996,1559,879,740,27.45%,15.48%,13%,72,6065,1.27%,98.73%,5809,11,63,13,0,27,
0500000US55053,"Jackson County, Wisconsin",20556,9525,46.34%,53.66%,48.3,828,4.03%,700,450,91,6244,1629,1408,871,13206,2279,6944,2079,1499,33.78%,10.11%,7%,678,20467,3.30%,96.70%,17939,440,1319,73,0,45,
0500000US55055,"Jefferson County, Wisconsin",84837,42356,49.93%,50.07%,52.6,3332,3.93%,2930,3866,551,19214,6850,10956,4811,54382,15767,22144,10716,11507,26.10%,12.63%,14%,7068,77832,8.33%,91.67%,73325,864,206,646,19,202,
0500000US55057,"Juneau County, Wisconsin",26603,12362,46.47%,53.53%,51.3,2148,8.07%,836,574,109,7882,2185,2029,903,17568,2932,8718,2759,2138,32.77%,10.37%,8%,727,25991,2.73%,97.27%,24008,548,355,147,1,52,
0500000US55059,"Kenosha County, Wisconsin",168998,85532,50.61%,49.39%,47.8,8027,4.75%,5933,6526,1776,33456,11424,20237,11461,102972,31698,39389,17950,22013,23.31%,10.62%,13%,24546,144605,14.52%,85.48%,121936,11480,371,2793,67,528,
0500000US55061,"Kewaunee County, Wisconsin",20398,10054,49.29%,50.71%,62.2,655,3.21%,513,687,121,5715,1963,2149,749,13623,2898,6228,2650,2270,30.53%,12.99%,11%,834,19729,4.09%,95.91%,18992,57,55,64,2,41,
0500000US55063,"La Crosse County, Wisconsin",118168,60645,51.32%,48.68%,44.6,7143,6.04%,4725,11480,1852,18928,9889,17223,10265,72566,27488,23653,21369,19075,20.02%,18.08%,16%,3051,117733,2.58%,97.42%,105307,1927,440,5599,16,385,
0500000US55065,"Lafayette County, Wisconsin",16682,8250,49.46%,50.55%,54.8,1024,6.14%,354,522,65,4618,1366,1541,670,10433,2211,4972,1888,1606,29.80%,11.32%,10%,1089,15522,6.53%,93.47%,15081,27,20,36,4,19,
0500000US55067,"Langlade County, Wisconsin",19167,9451,49.31%,50.69%,56.5,1057,5.51%,642,304,282,5969,1506,1516,818,12650,2334,6611,1810,1798,34.49%,9.44%,9%,459,19032,2.39%,97.61%,17960,105,235,67,4,36,
0500000US55069,"Lincoln County, Wisconsin",27687,13753,49.67%,50.33%,55.7,1087,3.93%,827,720,171,8003,2588,2675,1179,18930,3854,8830,3308,2846,31.89%,11.95%,10%,529,27886,1.91%,98.09%,26734,148,108,117,2,35,
0500000US55071,"Manitowoc County, Wisconsin",78977,39576,50.11%,49.89%,53.8,2992,3.79%,2336,2170,489,20679,7064,8704,3771,52906,12475,23015,9234,9193,29.14%,11.69%,12%,4050,77309,5.13%,94.87%,70951,1027,371,2247,15,212,
0500000US55073,"Marathon County, Wisconsin",135485,67539,49.85%,50.15%,57.6,4114,3.04%,4228,3982,1079,31860,12723,17193,7479,86823,24672,36088,16705,18272,26.64%,12.33%,13%,4453,133560,3.29%,96.71%,118783,1141,546,8431,29,340,
0500000US55075,"Marinette County, Wisconsin",40312,20049,49.74%,50.27%,54.5,1943,4.82%,935,1078,144,12138,3506,3283,1665,27360,4948,13073,4584,3427,32.43%,11.37%,9%,1079,40793,2.68%,97.32%,38754,192,203,180,8,96,
0500000US55077,"Marquette County, Wisconsin",15380,7528,48.95%,51.05%,54.6,595,3.87%,442,258,46,4779,1243,1163,468,10403,1631,5221,1501,1209,33.95%,9.76%,8%,488,15104,3.17%,96.83%,14477,44,60,51,5,45,
0500000US55078,"Menominee County, Wisconsin",4566,2276,49.85%,50.15%,33.7,718,15.72%,414,27,14,1134,300,257,187,2385,444,1548,327,271,33.90%,7.16%,6%,136,4119,2.98%,97.02%,483,2,3549,2,2,0,
0500000US55079,"Milwaukee County, Wisconsin",949180,489681,51.59%,48.41%,37,75908,8.00%,29198,39598,9946,183048,49869,126353,71290,559708,197643,212246,89467,136299,22.36%,9.43%,14%,153017,786472,16.12%,83.88%,456520,240416,3878,45989,262,4227,
0500000US55081,"Monroe County, Wisconsin",46155,22601,48.97%,51.03%,52.5,1464,3.17%,1450,928,197,11116,3703,4629,2032,28342,6661,12566,4631,4826,27.23%,10.03%,10%,2560,43714,5.55%,94.45%,40608,620,493,352,63,111,
0500000US55083,"Oconto County, Wisconsin",37870,18531,48.93%,51.07%,59,1602,4.23%,1029,845,217,11556,3390,3567,1166,25400,4733,12585,4235,3784,33.23%,11.18%,10%,848,38117,2.24%,97.76%,36170,91,463,110,0,66,
0500000US55085,"Oneida County, Wisconsin",35480,17653,49.76%,50.25%,58.4,950,2.68%,784,709,300,8559,3299,4531,2642,25582,7173,9343,4008,4831,26.33%,11.30%,14%,575,37270,1.62%,98.38%,35264,205,441,195,18,117,
0500000US55087,"Outagamie County, Wisconsin",186829,93565,50.08%,49.92%,55,4731,2.53%,5617,6970,1537,39243,17002,26515,11605,119434,38120,44860,23972,28052,24.01%,12.83%,15%,9423,181282,5.04%,94.96%,161879,2929,2743,6588,112,415,
0500000US55089,"Ozaukee County, Wisconsin",89179,45202,50.69%,49.31%,58.5,2115,2.37%,2278,3619,1165,12983,4871,18995,11905,60263,30900,15261,8490,20160,17.11%,9.52%,23%,3098,88405,3.47%,96.53%,81410,1483,167,2283,14,343,
0500000US55091,"Pepin County, Wisconsin",7261,3550,48.89%,51.11%,61.2,256,3.53%,177,140,42,2015,624,745,308,4767,1053,2192,764,787,30.19%,10.52%,11%,157,7161,2.16%,97.84%,6866,20,33,22,0,7,
0500000US55093,"Pierce County, Wisconsin",42336,21307,50.33%,49.67%,50.5,1669,3.94%,1283,4773,451,8163,3303,5266,2711,25268,7977,9446,8076,5717,22.31%,19.08%,14%,1220,40992,2.88%,97.12%,38535,402,209,289,10,139,
0500000US55095,"Polk County, Wisconsin",43549,21601,49.60%,50.40%,58.3,1528,3.51%,1201,1101,172,11375,4231,4962,2169,29691,7131,12576,5332,5134,28.88%,12.24%,12%,947,44030,2.17%,97.83%,41772,159,370,205,7,130,
0500000US55097,"Portage County, Wisconsin",70822,34985,49.40%,50.60%,48.3,3586,5.06%,3065,6538,1153,14623,5130,10697,4613,43086,15310,17688,11668,11850,24.98%,16.48%,17%,2620,67757,3.70%,96.30%,62212,903,242,2252,16,142,
0500000US55099,"Price County, Wisconsin",13351,6478,48.52%,51.48%,58.2,646,4.84%,228,403,68,4068,1366,1277,462,9485,1739,4296,1769,1345,32.18%,13.25%,10%,180,13874,1.35%,98.65%,13157,31,83,67,124,38,
0500000US55101,"Racine County, Wisconsin",195859,98776,50.43%,49.57%,49.7,12485,6.37%,6546,5303,1442,42216,14484,22829,11740,122138,34569,48762,19787,24271,24.90%,10.10%,12%,27911,169816,14.25%,85.75%,135333,22531,538,2261,47,792,
0500000US55103,"Richland County, Wisconsin",17408,8691,49.93%,50.08%,52.7,974,5.60%,579,463,41,4968,1364,1571,866,11166,2437,5547,1827,1612,31.86%,10.50%,9%,526,16778,3.02%,96.98%,16014,92,42,95,0,24,
0500000US55105,"Rock County, Wisconsin",162532,82489,50.75%,49.25%,49.3,7617,4.69%,5310,6171,755,38365,12909,17758,8330,101722,26088,43675,19080,18513,26.87%,11.74%,11%,15800,147887,9.72%,90.28%,129796,8060,386,2022,50,523,
0500000US55107,"Rusk County, Wisconsin",14074,7026,49.92%,50.08%,57,444,3.15%,323,365,34,4153,1316,1216,525,9131,1741,4476,1681,1250,31.80%,11.94%,9%,250,13938,1.78%,98.22%,13287,44,58,53,5,36,
0500000US55109,"St. Croix County, Wisconsin",89702,44772,49.91%,50.09%,60.2,1885,2.10%,2374,2768,748,14711,8740,15392,6968,58576,22360,17085,11508,16140,19.05%,12.83%,18%,2679,90857,2.99%,97.01%,85457,635,233,984,33,309,
0500000US55111,"Sauk County, Wisconsin",64152,32232,50.24%,49.76%,54.3,2164,3.37%,1643,1828,444,15312,5373,7418,3228,40862,10646,16955,7201,7862,26.43%,11.22%,12%,4050,61713,6.31%,93.69%,57868,578,764,394,15,148,
0500000US55113,"Sawyer County, Wisconsin",16477,8027,48.72%,51.28%,55.9,1194,7.25%,300,457,64,4082,1339,1993,1087,11415,3080,4382,1796,2057,26.59%,10.90%,12%,358,17716,2.17%,97.83%,13817,96,2861,63,2,54,
0500000US55115,"Shawano County, Wisconsin",40813,20435,50.07%,49.93%,55.2,1640,4.02%,1390,853,177,12792,3718,3248,1521,26862,4769,14182,4571,3425,34.75%,11.20%,8%,1176,39705,2.88%,97.12%,34404,117,3309,165,6,59,
0500000US55117,"Sheboygan County, Wisconsin",115152,57128,49.61%,50.39%,54.4,3296,2.86%,3570,3711,1232,28171,9123,14376,6229,75016,20605,31741,12834,15608,27.56%,11.15%,14%,8662,109372,7.52%,92.48%,95837,2434,362,6875,21,360,
0500000US55119,"Taylor County, Wisconsin",20320,10044,49.43%,50.57%,59.9,622,3.06%,492,592,42,6028,1443,1515,779,12475,2294,6520,2035,1557,32.09%,10.01%,8%,567,19346,2.79%,97.21%,18713,64,39,62,5,14,
0500000US55121,"Trempealeau County, Wisconsin",29525,14524,49.19%,50.81%,54.7,810,2.74%,816,786,156,7843,2969,2699,1122,18476,3821,8659,3755,2855,29.33%,12.72%,10%,3957,26803,13.40%,86.60%,25830,81,82,109,0,52,
0500000US55123,"Vernon County, Wisconsin",30759,15242,49.55%,50.45%,54.9,1827,5.94%,751,696,124,7591,2440,3126,1610,18611,4736,8342,3136,3250,27.12%,10.20%,11%,464,30250,1.51%,98.49%,29179,121,41,89,9,96,
0500000US55125,"Vilas County, Wisconsin",21923,10823,49.37%,50.63%,59.9,880,4.01%,447,307,165,5385,1817,3102,1687,16329,4789,5832,2124,3267,26.60%,9.69%,15%,459,22588,2.09%,97.91%,19569,49,2181,57,0,61,
0500000US55127,"Walworth County, Wisconsin",103391,51828,50.13%,49.87%,52.6,3984,3.85%,3998,6782,1190,20975,6467,12932,7361,62977,20293,24973,13249,14122,24.15%,12.81%,14%,12550,93928,12.14%,87.86%,88104,1166,229,1002,10,268,
0500000US55129,"Washburn County, Wisconsin",15726,7909,50.29%,49.71%,61.6,731,4.65%,347,280,80,3924,1534,1940,753,11034,2693,4271,1814,2020,27.16%,11.54%,13%,299,16324,1.90%,98.10%,15348,30,182,59,4,36,
0500000US55131,"Washington County, Wisconsin",135529,68279,50.38%,49.62%,59.1,3667,2.71%,3299,3784,1779,28286,11529,22185,9393,91165,31578,31585,15313,23964,23.30%,11.30%,18%,4827,131934,3.56%,96.44%,123855,1672,272,1943,28,407,
0500000US55133,"Waukesha County, Wisconsin",402637,204475,50.78%,49.22%,59.4,8885,2.21%,9550,13664,4820,62070,26858,84600,42942,273957,127542,71620,40522,89420,17.79%,10.06%,22%,21835,385143,5.42%,94.58%,347922,6648,807,15616,121,1138,
0500000US55135,"Waupaca County, Wisconsin",50997,24973,48.97%,51.03%,56.1,1605,3.15%,1633,1207,218,15286,4022,5600,2171,34037,7771,16919,5229,5818,33.18%,10.25%,11%,1864,49948,3.66%,96.34%,47784,202,242,254,4,105,
0500000US55137,"Waushara County, Wisconsin",24256,11445,47.18%,52.82%,56,925,3.81%,637,379,90,7744,1579,2010,1050,16254,3060,8381,1958,2100,34.55%,8.07%,9%,1693,22827,6.98%,93.02%,21552,389,121,98,14,50,
0500000US55139,"Winnebago County, Wisconsin",170924,84750,49.58%,50.42%,46.5,9247,5.41%,5965,10514,2191,38053,12828,23770,9736,107951,33506,44018,23342,25961,25.75%,13.66%,15%,8328,163402,4.87%,95.13%,145581,4931,935,5560,53,362,
0500000US55141,"Wood County, Wisconsin",72892,37025,50.79%,49.21%,53.2,2491,3.42%,1819,2125,439,19886,6662,6709,4016,48126,10725,21705,8787,7148,29.78%,12.05%,10%,2376,71831,3.26%,96.74%,67055,547,549,1382,29,190,
0500000US56001,"Albany County, Wyoming",38664,18756,48.51%,51.49%,41.7,3469,8.97%,1645,7104,1879,2903,1591,6460,5523,20785,11983,4548,8695,8339,11.76%,22.49%,22%,3910,33156,10.11%,89.89%,29584,384,282,1028,30,188,
0500000US56003,"Big Horn County, Wyoming",11809,5737,48.58%,51.42%,52.5,515,4.36%,341,332,14,2301,946,1071,529,7155,1600,2642,1278,1085,22.37%,10.82%,9%,1069,10452,9.05%,90.95%,9884,22,98,44,6,44,
0500000US56005,"Campbell County, Wyoming",46958,22768,48.49%,51.51%,60.1,2597,5.53%,1614,1545,86,10817,3613,3991,1973,28161,5964,12431,5158,4077,26.47%,10.98%,9%,4283,42743,9.12%,90.88%,39601,219,509,320,25,188,
0500000US56007,"Carbon County, Wyoming",15073,6981,46.32%,53.69%,55.7,1031,6.84%,594,358,22,3913,1019,1633,489,9391,2122,4507,1377,1655,29.90%,9.14%,11%,2600,11937,17.25%,82.75%,11006,130,155,89,15,60,
0500000US56009,"Converse County, Wyoming",13842,6688,48.32%,51.68%,60.8,501,3.62%,285,196,34,3316,1244,1049,816,8699,1865,3601,1440,1083,26.02%,10.40%,8%,1062,12689,7.67%,92.33%,11996,39,72,55,0,41,
0500000US56011,"Crook County, Wyoming",7502,3758,50.09%,49.91%,65.9,519,6.92%,132,121,21,1573,612,997,251,4831,1248,1705,733,1018,22.73%,9.77%,14%,112,7069,1.49%,98.51%,6766,0,43,9,7,16,
0500000US56013,"Fremont County, Wyoming",39711,19863,50.02%,49.98%,45.9,2053,5.17%,1180,1021,274,8049,3001,4038,2577,24474,6615,9229,4022,4312,23.24%,10.13%,11%,2421,36813,6.10%,93.90%,26586,166,7798,205,7,136,
0500000US56015,"Goshen County, Wyoming",13301,6463,48.59%,51.41%,56.3,557,4.19%,400,559,25,2592,1076,1436,953,8544,2389,2992,1635,1461,22.49%,12.29%,11%,1212,11286,9.11%,90.89%,10695,76,83,46,0,42,
0500000US56017,"Hot Springs County, Wyoming",4550,2265,49.78%,50.22%,62.1,314,6.90%,108,70,0,853,424,508,292,3200,800,961,494,508,21.12%,10.86%,11%,177,4444,3.89%,96.11%,4142,9,42,18,3,16,
0500000US56019,"Johnson County, Wyoming",8518,4028,47.29%,52.71%,60.7,638,7.49%,471,134,0,1554,526,1285,772,5906,2057,2025,660,1285,23.77%,7.75%,15%,347,8100,4.07%,95.93%,7640,26,69,15,7,28,
0500000US56021,"Laramie County, Wyoming",99272,48791,49.15%,50.85%,54.4,4433,4.47%,4027,3277,586,17238,8705,12776,7650,63634,20426,21265,11982,13362,21.42%,12.07%,13%,15602,84910,15.72%,84.28%,75279,2200,596,1228,136,518,
0500000US56023,"Lincoln County, Wyoming",19640,9664,49.21%,50.79%,62.7,669,3.41%,321,472,116,4274,1698,1931,990,12146,2921,4595,2170,2047,23.40%,11.05%,10%,959,18622,4.88%,95.12%,17737,34,101,96,21,91,
0500000US56025,"Natrona County, Wyoming",80067,40068,50.04%,49.96%,50.8,3032,3.79%,2621,2646,329,16065,6607,7975,4851,51099,12826,18686,9253,8304,23.34%,11.56%,10%,7169,72786,8.95%,91.05%,66614,729,767,633,78,306,
0500000US56027,"Niobrara County, Wyoming",2377,1379,58.01%,41.99%,55.3,115,4.84%,22,89,0,569,174,255,43,1578,298,591,263,255,24.86%,11.06%,11%,76,2391,3.20%,96.80%,2255,6,27,12,5,0,
0500000US56029,"Park County, Wyoming",29273,14847,50.72%,49.28%,61.4,775,2.65%,824,899,131,5330,3025,4605,2747,20215,7352,6154,3924,4736,21.02%,13.40%,16%,1697,27927,5.80%,94.20%,26316,59,120,211,17,148,
0500000US56031,"Platte County, Wyoming",8572,4153,48.45%,51.55%,64.3,322,3.76%,116,207,96,2487,834,702,550,5949,1252,2603,1041,798,30.37%,12.14%,9%,695,7910,8.11%,91.89%,7469,19,67,43,4,33,
0500000US56033,"Sheridan County, Wyoming",30397,15276,50.26%,49.75%,53.4,1312,4.32%,842,1186,161,5976,1917,3618,2979,20551,6597,6818,3103,3779,22.43%,10.21%,12%,1416,29505,4.66%,95.34%,27509,110,324,180,17,126,
0500000US56035,"Sublette County, Wyoming",9865,4311,43.70%,56.30%,58.7,477,4.84%,415,329,4,2080,597,1471,473,6457,1944,2495,926,1475,25.29%,9.39%,15%,636,8092,6.45%,93.55%,7651,17,44,46,10,45,
0500000US56037,"Sweetwater County, Wyoming",43352,21012,48.47%,51.53%,51.1,2165,4.99%,1539,1623,225,9115,3801,3877,2112,26138,5989,10654,5424,4102,24.58%,12.51%,9%,6957,35315,16.05%,83.95%,32362,351,259,283,61,147,
0500000US56039,"Teton County, Wyoming",23356,11021,47.19%,52.81%,54.2,672,2.88%,170,931,172,2778,776,6620,3169,16837,9789,2948,1707,6792,12.62%,7.31%,29%,3295,20036,14.11%,85.89%,18754,49,66,309,3,99,
0500000US56041,"Uinta County, Wyoming",20374,10059,49.37%,50.63%,60.4,845,4.15%,504,631,59,4931,1478,1644,857,12190,2501,5435,2109,1703,26.68%,10.35%,8%,1986,18464,9.75%,90.25%,17444,50,122,108,27,76,
0500000US56043,"Washakie County, Wyoming",7933,3897,49.12%,50.88%,60.8,408,5.14%,150,207,32,1587,689,829,484,5074,1313,1737,896,861,21.90%,11.29%,11%,1070,6615,13.49%,86.51%,6268,12,45,33,1,43,
0500000US56045,"Weston County, Wyoming",6942,3283,47.29%,52.71%,57.8,470,6.77%,208,235,68,1882,591,625,223,4604,848,2090,826,693,30.11%,11.90%,10%,295,6543,4.25%,95.75%,6106,28,92,26,9,34,
0500000US72001,"Adjuntas Municipio, Puerto Rico",17614,8899,50.52%,49.48%,37.1,6155,34.94%,403,746,204,3533,1326,1732,304,8145,2036,3936,2072,1936,22.35%,11.76%,11%,17961,59,98.60%,1.40%,39,1,0,0,0,9,
0500000US72003,"Aguada Municipio, Puerto Rico",37307,19073,51.12%,48.88%,40.1,9264,24.83%,700,1890,604,7158,3074,4247,1365,18008,5612,7858,4964,4851,21.06%,13.31%,13%,37860,276,96.33%,3.67%,217,12,3,10,0,13,
0500000US72005,"Aguadilla Municipio, Puerto Rico",51552,26594,51.59%,48.41%,39.1,15886,30.82%,1615,2302,424,10951,2766,6316,2532,27357,8848,12566,5068,6740,24.38%,9.83%,13%,54227,874,100.00%,0.00%,628,90,5,55,1,32,
0500000US72007,"Aguas Buenas Municipio, Puerto Rico",25298,12833,50.73%,49.27%,35.3,5793,22.90%,611,1499,189,5905,1925,2628,524,13182,3152,6516,3424,2817,25.76%,13.53%,11%,24091,132,95.23%,4.77%,93,12,1,6,0,12,
0500000US72009,"Aibonito Municipio, Puerto Rico",22545,11749,52.11%,47.89%,38,4366,19.37%,794,974,108,5811,1350,2498,1279,12870,3777,6605,2324,2606,29.30%,10.31%,12%,24410,227,100.00%,0.00%,140,19,0,3,0,37,
0500000US72011,"A√±asco Municipio, Puerto Rico",26555,13736,51.73%,48.27%,38.1,5269,19.84%,451,1540,349,5987,2166,2610,682,13210,3292,6438,3706,2959,24.24%,13.96%,11%,25344,252,93.50%,6.50%,184,20,0,5,4,17,
0500000US72013,"Arecibo Municipio, Puerto Rico",83682,43761,52.29%,47.71%,37.4,20058,23.97%,2019,4474,935,17915,6380,11011,3425,46868,14436,19934,10854,11946,23.82%,12.97%,14%,87117,637,97.80%,2.20%,455,62,0,45,0,49,
0500000US72015,"Arroyo Municipio, Puerto Rico",17502,9335,53.34%,46.66%,30.6,6235,35.62%,886,486,100,4337,1245,1921,370,9373,2291,5223,1731,2021,29.84%,9.89%,12%,15708,135,89.75%,10.25%,69,26,1,7,0,18,
0500000US72017,"Barceloneta Municipio, Puerto Rico",23913,12598,52.68%,47.32%,32.9,6776,28.34%,827,1258,64,5410,1458,3013,792,12465,3805,6237,2716,3077,26.08%,11.36%,13%,22542,115,94.27%,5.73%,71,9,12,3,0,11,
0500000US72019,"Barranquitas Municipio, Puerto Rico",28026,14226,50.76%,49.24%,34.9,8215,29.31%,682,1804,354,5547,1654,2805,956,13968,3761,6229,3458,3159,22.23%,12.34%,11%,28905,78,99.80%,0.20%,48,6,1,4,3,12,
0500000US72021,"Bayam√≥n Municipio, Puerto Rico",173695,92006,52.97%,47.03%,36.9,30816,17.74%,4128,9190,1689,30183,13479,27060,9975,103432,37035,34311,22669,28749,19.75%,13.05%,17%,183263,1924,100.00%,0.00%,1232,225,22,176,4,140,
0500000US72023,"Cabo Rojo Municipio, Puerto Rico",47977,25289,52.71%,47.29%,37.1,14337,29.88%,837,2742,351,9014,3247,6871,2196,25119,9067,9851,5989,7222,20.53%,12.48%,15%,46589,569,97.11%,2.89%,427,41,3,34,0,39,
0500000US72025,"Caguas Municipio, Puerto Rico",126734,67927,53.60%,46.40%,34.9,25207,19.89%,3213,6980,959,24341,9128,20920,8850,75393,29770,27554,16108,21879,21.74%,12.71%,17%,126270,974,99.63%,0.37%,562,99,11,86,6,123,
0500000US72027,"Camuy Municipio, Puerto Rico",31066,16248,52.30%,47.70%,44.4,6731,21.67%,675,1921,272,5603,3862,3568,1272,16276,4840,6278,5783,3840,20.21%,18.62%,12%,32525,302,96.50%,3.50%,250,8,3,5,0,21,
0500000US72029,"Can√≥vanas Municipio, Puerto Rico",45120,23438,51.95%,48.05%,37,9177,20.34%,1246,2401,357,9599,3540,5218,2372,24163,7590,10845,5941,5575,24.04%,13.17%,12%,42044,293,93.18%,6.82%,132,88,3,24,0,23,
0500000US72031,"Carolina Municipio, Puerto Rico",150378,81715,54.34%,45.66%,34.7,23417,15.57%,3505,8596,1285,28390,14168,26306,9878,93881,36184,31895,22764,27591,21.21%,15.14%,18%,152417,2398,100.00%,0.00%,1536,313,10,272,11,138,
0500000US72033,"Cata√±o Municipio, Puerto Rico",23698,12522,52.84%,47.16%,31.8,6339,26.75%,865,934,186,5523,1799,2323,1099,12711,3422,6388,2733,2509,26.96%,11.53%,11%,22923,232,96.73%,3.27%,123,44,0,31,7,18,
0500000US72035,"Cayey Municipio, Puerto Rico",43126,22464,52.09%,47.91%,37,8632,20.02%,741,2521,470,9855,2553,5943,2263,24310,8206,10596,5074,6413,24.57%,11.77%,15%,41400,252,96.00%,4.00%,157,28,6,20,2,13,
0500000US72037,"Ceiba Municipio, Puerto Rico",11207,5903,52.67%,47.33%,37,2118,18.90%,223,687,65,2521,808,1303,292,6008,1595,2744,1495,1368,24.48%,13.34%,12%,11099,208,99.04%,0.96%,145,24,4,11,0,18,
0500000US72039,"Ciales Municipio, Puerto Rico",16188,8264,51.05%,48.95%,41.7,4217,26.05%,345,780,50,3474,1179,1437,371,8010,1808,3819,1959,1487,23.59%,12.10%,9%,16891,93,98.70%,1.30%,51,5,3,14,0,15,
0500000US72041,"Cidra Municipio, Puerto Rico",38977,20138,51.67%,48.33%,37.9,8374,21.48%,717,2315,385,8654,3047,4627,2131,21387,6758,9371,5362,5012,24.04%,13.76%,13%,39762,208,96.60%,3.40%,155,16,0,0,0,24,
0500000US72043,"Coamo Municipio, Puerto Rico",38603,19895,51.54%,48.46%,33.8,10793,27.96%,832,1734,323,10908,2272,4565,1311,22106,5876,11740,4006,4888,30.41%,10.38%,13%,34464,204,89.28%,10.72%,95,17,3,14,3,53,
0500000US72045,"Comer√≠o Municipio, Puerto Rico",18942,9636,50.87%,49.13%,26.7,5663,29.90%,531,834,280,3356,1736,1592,350,9518,1942,3887,2570,1872,20.52%,13.57%,10%,18812,71,99.31%,0.69%,43,8,0,0,0,16,
0500000US72047,"Corozal Municipio, Puerto Rico",32928,17002,51.63%,48.37%,40.8,10372,31.50%,726,1972,231,6240,2270,3662,1157,16496,4819,6966,4242,3893,21.16%,12.88%,12%,34396,175,95.00%,5.00%,94,20,0,12,11,30,
0500000US72049,"Culebra Municipio, Puerto Rico",1371,640,46.68%,53.32%,28.8,59,4.30%,56,52,0,340,116,154,20,763,174,396,168,154,28.88%,12.25%,11%,1599,193,95.20%,4.80%,176,0,0,3,0,4,
0500000US72051,"Dorado Municipio, Puerto Rico",36475,19153,52.51%,47.49%,39.8,6976,19.13%,1024,1724,284,7070,2243,5323,2612,20598,7935,8094,3967,5607,22.19%,10.88%,15%,34666,1213,95.04%,4.96%,923,67,4,88,2,37,
0500000US72053,"Fajardo Municipio, Puerto Rico",30263,16169,53.43%,46.57%,33.3,7277,24.05%,815,1672,254,7164,1789,4560,1363,17453,5923,7979,3461,4814,26.37%,11.44%,16%,31554,570,96.40%,3.60%,310,112,14,27,2,67,
0500000US72054,"Florida Municipio, Puerto Rico",11513,5967,51.83%,48.17%,42.4,2928,25.43%,451,607,0,2805,949,1044,251,6228,1295,3256,1556,1044,28.28%,13.52%,9%,11637,55,97.60%,2.40%,39,4,0,2,0,7,
0500000US72055,"Gu√°nica Municipio, Puerto Rico",15825,8213,51.90%,48.10%,29.9,6229,39.36%,613,627,190,4000,1246,1393,361,7731,1754,4613,1873,1583,29.15%,11.84%,10%,13663,124,86.34%,13.66%,95,13,0,0,0,10,
0500000US72057,"Guayama Municipio, Puerto Rico",40198,20269,50.42%,49.58%,32,10619,26.42%,1515,1763,291,10641,2229,4541,1667,21722,6208,12156,3992,4832,30.24%,9.93%,12%,36371,243,90.48%,9.52%,142,18,2,20,3,34,
0500000US72059,"Guayanilla Municipio, Puerto Rico",18080,9502,52.56%,47.45%,35.6,5201,28.77%,322,1083,90,4032,1733,2458,687,9867,3145,4354,2816,2548,24.08%,15.58%,14%,17721,63,98.01%,1.99%,29,3,0,1,2,8,
0500000US72061,"Guaynabo Municipio, Puerto Rico",85312,45193,52.97%,47.03%,36.6,9380,10.99%,2141,3692,1207,10775,6014,18601,10842,54828,29443,12916,9706,19808,15.14%,11.38%,23%,87894,1886,100.00%,0.00%,1226,286,9,165,5,89,
0500000US72063,"Gurabo Municipio, Puerto Rico",46948,24833,52.90%,47.11%,41.2,7165,15.26%,1496,2165,388,8275,3550,7312,3758,27189,11070,9771,5715,7700,20.81%,12.17%,16%,40316,306,85.87%,14.13%,193,41,11,9,0,27,
0500000US72065,"Hatillo Municipio, Puerto Rico",39561,20600,52.07%,47.93%,44.1,7992,20.20%,548,2269,508,6651,5155,5670,2111,21558,7781,7199,7424,6178,18.20%,18.77%,16%,38171,315,96.49%,3.51%,216,45,2,21,0,7,
0500000US72067,"Hormigueros Municipio, Puerto Rico",15731,8501,54.04%,45.96%,36.6,2862,18.19%,227,1026,8,3703,1040,2205,626,9160,2831,3930,2066,2213,24.98%,13.13%,14%,15536,118,98.76%,1.24%,78,15,1,7,0,9,
0500000US72069,"Humacao Municipio, Puerto Rico",51586,27269,52.86%,47.14%,39,10123,19.62%,1234,2545,459,12268,4300,6513,2584,29703,9097,13502,6845,6972,26.17%,13.27%,14%,49903,993,96.74%,3.26%,737,95,0,74,0,35,
0500000US72071,"Isabela Municipio, Puerto Rico",41084,21130,51.43%,48.57%,38.5,11862,28.87%,664,2162,372,8262,3001,5183,1994,21209,7177,8926,5163,5555,21.73%,12.57%,14%,42395,548,100.00%,0.00%,408,43,1,23,1,35,
0500000US72073,"Jayuya Municipio, Puerto Rico",14239,7214,50.66%,49.34%,38.6,4736,33.26%,354,902,0,3690,590,1419,583,7609,2002,4044,1492,1419,28.40%,10.48%,10%,14703,76,100.00%,0.00%,55,9,0,3,0,8,
0500000US72075,"Juana D√≠az Municipio, Puerto Rico",45414,23850,52.52%,47.48%,37.6,10218,22.50%,1068,2340,518,10219,3488,6351,1738,24439,8089,11287,5828,6869,24.85%,12.83%,15%,46285,253,97.80%,2.20%,155,41,1,10,0,28,
0500000US72077,"Juncos Municipio, Puerto Rico",38471,20177,52.45%,47.55%,33,9557,24.84%,795,2559,198,7361,3136,4060,1300,19886,5360,8156,5695,4258,21.20%,14.80%,11%,36794,218,95.64%,4.36%,132,30,5,0,0,41,
0500000US72079,"Lajas Municipio, Puerto Rico",22391,11510,51.41%,48.60%,34.7,7141,31.89%,878,1027,216,4521,2032,2122,571,10604,2693,5399,3059,2338,24.11%,13.66%,10%,23160,174,98.50%,1.50%,126,18,0,7,0,18,
0500000US72081,"Lares Municipio, Puerto Rico",24945,12675,50.81%,49.19%,47.9,7819,31.34%,551,1343,69,4530,2225,2658,744,11914,3402,5081,3568,2727,20.37%,14.30%,11%,27909,196,97.50%,2.50%,113,7,5,9,0,49,
0500000US72083,"Las Mar√≠as Municipio, Puerto Rico",8131,4065,49.99%,50.01%,45,2873,35.33%,297,325,99,2016,424,865,114,3650,979,2313,749,964,28.45%,9.21%,12%,8803,71,97.80%,2.20%,42,9,0,4,0,4,
0500000US72085,"Las Piedras Municipio, Puerto Rico",37233,19367,52.02%,47.98%,39.9,6683,17.95%,609,2085,449,6498,3257,4642,1724,20935,6366,7107,5342,5091,19.09%,14.35%,14%,34983,197,93.96%,6.04%,126,25,0,16,0,19,
0500000US72087,"Lo√≠za Municipio, Puerto Rico",25164,13467,53.52%,46.48%,28.2,7535,29.94%,652,1463,103,6970,2142,2411,425,13410,2836,7622,3605,2514,30.29%,14.33%,10%,23549,144,93.58%,6.42%,44,70,1,13,0,6,
0500000US72089,"Luquillo Municipio, Puerto Rico",17924,9443,52.68%,47.32%,36.4,4081,22.77%,691,795,106,4394,1381,2086,690,10058,2776,5085,2176,2192,28.37%,12.14%,12%,17263,518,96.31%,3.69%,384,62,6,21,3,21,
0500000US72091,"Manat√≠ Municipio, Puerto Rico",38062,20190,53.05%,46.96%,37.9,9433,24.78%,1291,1870,217,8041,2416,4828,1524,20211,6352,9332,4286,5045,24.52%,11.26%,13%,39198,294,100.00%,0.00%,200,33,0,20,0,29,
0500000US72093,"Maricao Municipio, Puerto Rico",5900,3021,51.20%,48.80%,26.5,2320,39.32%,125,296,28,1273,180,319,163,2342,482,1398,476,347,23.69%,8.07%,6%,4729,26,80.15%,19.85%,19,0,0,2,0,1,
0500000US72095,"Maunabo Municipio, Puerto Rico",10568,5406,51.15%,48.85%,36.4,2346,22.20%,152,600,112,2273,1029,1114,233,5690,1347,2425,1629,1226,22.95%,15.41%,12%,10530,59,99.64%,0.36%,31,19,0,2,0,1,
0500000US72097,"Mayag√ºez Municipio, Puerto Rico",73336,38359,52.31%,47.69%,31.5,25315,34.52%,2048,7803,732,13356,3100,9233,4443,35611,13676,15404,10903,9965,21.00%,14.87%,14%,72107,970,98.32%,1.68%,689,106,4,84,0,41,
0500000US72099,"Moca Municipio, Puerto Rico",35547,18220,51.26%,48.74%,45.3,11101,31.23%,1208,1737,357,7734,1652,3865,1459,17520,5324,8942,3389,4222,25.16%,9.53%,12%,37316,144,100.00%,0.00%,80,22,2,16,0,13,
0500000US72101,"Morovis Municipio, Puerto Rico",30652,15456,50.42%,49.58%,35.9,6131,20.00%,649,1924,282,6394,2730,3017,633,15617,3650,7043,4654,3299,22.98%,15.18%,11%,28604,123,93.32%,6.68%,86,1,2,6,1,14,
0500000US72103,"Naguabo Municipio, Puerto Rico",25931,13845,53.39%,46.61%,32.6,6079,23.44%,863,1244,192,6269,2032,2950,945,13402,3895,7132,3276,3142,27.50%,12.63%,12%,23190,196,89.43%,10.57%,136,16,0,14,0,17,
0500000US72105,"Naranjito Municipio, Puerto Rico",27719,14133,50.99%,49.01%,35.5,7281,26.27%,512,1658,257,4841,2189,2762,590,14171,3352,5353,3847,3019,19.31%,13.88%,11%,29131,110,100.00%,0.00%,84,11,2,1,0,2,
0500000US72107,"Orocovis Municipio, Puerto Rico",20608,10306,50.01%,49.99%,33.4,7413,35.97%,602,1118,136,4597,1325,1906,481,9830,2387,5199,2443,2042,25.23%,11.85%,10%,21338,96,100.00%,0.00%,64,14,6,3,0,7,
0500000US72109,"Patillas Municipio, Puerto Rico",16591,8523,51.37%,48.63%,38,4362,26.29%,258,999,104,3488,1456,1458,742,9247,2200,3746,2455,1562,22.58%,14.80%,9%,15878,107,95.70%,4.30%,66,17,0,0,0,8,
0500000US72111,"Pe√±uelas Municipio, Puerto Rico",19797,10212,51.58%,48.42%,36.4,6162,31.13%,299,1142,145,3960,1984,2566,476,9964,3042,4259,3126,2711,21.51%,15.79%,14%,20299,100,100.00%,0.00%,67,13,0,8,0,10,
0500000US72113,"Ponce Municipio, Puerto Rico",135674,70612,52.05%,47.96%,33.1,39953,29.45%,4457,6793,1088,29563,8270,19920,7575,74640,27495,34020,15063,21008,25.07%,11.10%,15%,136300,1191,100.00%,0.00%,799,115,14,107,1,76,
0500000US72115,"Quebradillas Municipio, Puerto Rico",23261,12075,51.91%,48.09%,39.8,6034,25.94%,305,1258,186,5013,2055,2425,928,12336,3353,5318,3313,2611,22.86%,14.24%,11%,23441,197,100.00%,0.00%,153,8,0,7,2,8,
0500000US72117,"Rinc√≥n Municipio, Puerto Rico",13849,7257,52.40%,47.60%,38.2,2473,17.86%,250,780,27,2754,1495,1792,529,7463,2321,3004,2275,1819,21.69%,16.43%,13%,14409,778,100.00%,0.00%,691,23,6,11,0,18,
0500000US72119,"R√≠o Grande Municipio, Puerto Rico",48828,25410,52.04%,47.96%,34.9,8581,17.57%,1520,2416,598,11297,3766,6918,1529,27513,8447,12817,6182,7516,26.25%,12.66%,15%,46484,576,95.20%,4.80%,381,91,6,32,0,37,
0500000US72121,"Sabana Grande Municipio, Puerto Rico",22140,11961,54.02%,45.98%,33,3807,17.20%,791,727,419,5033,1894,2594,606,11811,3200,5824,2621,3013,26.31%,11.84%,14%,22602,127,100.00%,0.00%,92,12,1,4,0,11,
0500000US72123,"Salinas Municipio, Puerto Rico",27638,14286,51.69%,48.31%,33.1,7233,26.17%,1077,796,382,7598,1547,2700,667,14207,3367,8675,2343,3082,31.39%,8.48%,11%,25577,212,92.54%,7.46%,161,23,0,0,0,17,
0500000US72125,"San Germ√°n Municipio, Puerto Rico",30811,15838,51.40%,48.60%,34.9,8815,28.61%,992,1605,218,6993,1563,3655,1458,15543,5113,7985,3168,3873,25.92%,10.28%,13%,31639,240,96.30%,3.70%,162,31,1,16,1,15,
0500000US72127,"San Juan Municipio, Puerto Rico",326953,177476,54.28%,45.72%,31.1,78622,24.05%,7791,16509,3388,51758,26895,56203,37731,197640,93934,59549,43404,59591,18.21%,13.28%,18%,334601,7658,94.50%,5.50%,4882,1071,58,796,7,340,
0500000US72129,"San Lorenzo Municipio, Puerto Rico",36586,18809,51.41%,48.59%,37.2,6582,17.99%,716,2234,190,6735,3229,3762,1319,19234,5081,7451,5463,3952,20.37%,14.93%,11%,37520,173,93.50%,6.50%,109,4,4,13,0,28,
0500000US72131,"San Sebasti√°n Municipio, Puerto Rico",36292,18685,51.49%,48.52%,43.7,10118,27.88%,874,1681,328,7125,2812,3993,1195,17899,5188,7999,4493,4321,22.04%,12.38%,12%,39110,235,95.50%,4.50%,166,13,4,3,0,38,
0500000US72133,"Santa Isabel Municipio, Puerto Rico",21474,11129,51.83%,48.18%,30.3,4592,21.38%,760,903,218,5877,1232,2704,957,12170,3661,6637,2135,2922,30.91%,9.94%,14%,20166,115,93.91%,6.09%,62,11,2,14,1,12,
0500000US72135,"Toa Alta Municipio, Puerto Rico",72450,37723,52.07%,47.93%,40.1,10454,14.43%,2283,3953,807,12860,8697,10703,3224,41678,13927,15143,12650,11510,20.90%,17.46%,16%,66453,399,91.72%,8.28%,235,38,4,41,1,42,
0500000US72137,"Toa Baja Municipio, Puerto Rico",76008,40532,53.33%,46.67%,35.2,15520,20.42%,2255,3568,612,14854,6646,10726,3543,44222,14269,17109,10214,11338,22.51%,13.44%,15%,74515,778,98.04%,1.96%,479,148,2,56,0,54,
0500000US72139,"Trujillo Alto Municipio, Puerto Rico",65011,34518,53.10%,46.90%,40.5,8779,13.50%,1306,3743,628,11290,5070,11909,4753,39489,16662,12596,8813,12537,19.38%,13.56%,19%,67126,614,94.60%,5.40%,405,70,0,33,0,49,
0500000US72141,"Utuado Municipio, Puerto Rico",28041,14460,51.57%,48.43%,36.8,8865,31.61%,557,1341,225,5677,1694,3160,751,14673,3911,6234,3035,3385,22.23%,10.82%,12%,28072,215,93.50%,6.50%,172,9,2,13,3,11,
0500000US72143,"Vega Alta Municipio, Puerto Rico",36559,19020,52.03%,47.98%,42.6,7126,19.49%,1370,1415,357,7252,2969,3862,2002,18886,5864,8622,4384,4219,23.58%,11.99%,12%,34967,428,95.65%,4.35%,254,57,6,46,0,53,
0500000US72145,"Vega Baja Municipio, Puerto Rico",51089,26669,52.20%,47.80%,38.5,12115,23.71%,1497,2345,401,10459,4167,5707,2241,26957,7948,11956,6512,6108,23.40%,12.75%,12%,54012,402,100.00%,0.00%,279,31,9,11,0,23,
0500000US72147,"Vieques Municipio, Puerto Rico",8508,4152,48.80%,51.20%,20.5,2487,29.23%,641,91,55,2726,566,434,348,4243,782,3367,657,489,39.57%,7.72%,6%,7586,663,89.16%,10.84%,533,47,15,3,0,55,
0500000US72149,"Villalba Municipio, Puerto Rico",21899,11310,51.65%,48.35%,35.4,6259,28.58%,567,1212,358,5624,1520,2413,557,11804,2970,6191,2732,2771,28.27%,12.48%,13%,22008,85,97.60%,2.40%,65,3,5,1,0,6,
0500000US72151,"Yabucoa Municipio, Puerto Rico",32867,16984,51.68%,48.33%,34.2,8250,25.10%,402,2108,386,6140,2847,3567,619,17054,4186,6542,4955,3953,19.90%,15.08%,12%,30258,168,92.06%,7.94%,115,12,1,8,2,18,
0500000US72153,"Yauco Municipio, Puerto Rico",34501,18017,52.22%,47.78%,36.2,9542,27.66%,830,1456,305,8760,2132,4785,1371,19137,6156,9590,3588,5090,27.80%,10.40%,15%,33982,190,98.50%,1.50%,136,11,3,15,2,10,